date,time,sensor_id,direction_1,direction_2,total_of_directions,date_time
2022/11/05,22:15,57,4,3,7,2022/11/05 10:15:00 PM
2022/11/05,22:18,23,8,0,8,2022/11/05 10:18:00 PM
2022/11/05,22:15,5,10,11,21,2022/11/05 10:15:00 PM
2022/11/05,22:24,4,12,11,23,2022/11/05 10:24:00 PM
2022/11/05,22:18,44,0,2,2,2022/11/05 10:18:00 PM
2022/11/05,22:31,56,3,3,6,2022/11/05 10:31:00 PM
2022/11/05,22:19,69,1,0,1,2022/11/05 10:19:00 PM
2022/11/05,22:17,21,10,5,15,2022/11/05 10:17:00 PM
2022/11/05,22:26,4,12,17,29,2022/11/05 10:26:00 PM
2022/11/05,22:26,9,0,1,1,2022/11/05 10:26:00 PM
2022/11/05,22:18,20,1,18,19,2022/11/05 10:18:00 PM
2022/11/05,22:31,1,3,0,3,2022/11/05 10:31:00 PM
2022/11/05,22:30,67,7,7,14,2022/11/05 10:30:00 PM
2022/11/05,22:15,21,61,11,72,2022/11/05 10:15:00 PM
2022/11/05,22:21,24,0,12,12,2022/11/05 10:21:00 PM
2022/11/05,22:21,77,7,0,7,2022/11/05 10:21:00 PM
2022/11/05,22:29,58,0,1,1,2022/11/05 10:29:00 PM
2022/11/05,22:29,29,24,4,28,2022/11/05 10:29:00 PM
2022/11/05,22:20,70,2,2,4,2022/11/05 10:20:00 PM
2022/11/05,22:27,1,0,7,7,2022/11/05 10:27:00 PM
2022/11/05,22:28,6,15,13,28,2022/11/05 10:28:00 PM
2022/11/05,22:25,35,24,24,48,2022/11/05 10:25:00 PM
2022/11/05,22:24,54,3,2,5,2022/11/05 10:24:00 PM
2022/11/05,22:28,28,11,26,37,2022/11/05 10:28:00 PM
2022/11/05,22:30,45,1,4,5,2022/11/05 10:30:00 PM
2022/11/05,22:20,58,4,4,8,2022/11/05 10:20:00 PM
2022/11/05,22:19,79,9,0,9,2022/11/05 10:19:00 PM
2022/11/05,22:31,27,0,5,5,2022/11/05 10:31:00 PM
2022/11/05,22:20,72,1,15,16,2022/11/05 10:20:00 PM
2022/11/05,22:22,29,29,11,40,2022/11/05 10:22:00 PM
2022/11/05,22:32,4,13,15,28,2022/11/05 10:32:00 PM
2022/11/05,22:20,4,22,9,31,2022/11/05 10:20:00 PM
2022/11/05,22:20,68,1,1,2,2022/11/05 10:20:00 PM
2022/11/05,22:25,56,4,4,8,2022/11/05 10:25:00 PM
2022/11/05,22:24,67,3,3,6,2022/11/05 10:24:00 PM
2022/11/05,22:28,62,3,3,6,2022/11/05 10:28:00 PM
2022/11/05,22:33,4,19,12,31,2022/11/05 10:33:00 PM
2022/11/05,22:28,5,7,4,11,2022/11/05 10:28:00 PM
2022/11/05,22:27,35,27,35,62,2022/11/05 10:27:00 PM
2022/11/05,22:30,47,22,4,26,2022/11/05 10:30:00 PM
2022/11/05,22:26,84,14,13,27,2022/11/05 10:26:00 PM
2022/11/05,22:28,4,20,9,29,2022/11/05 10:28:00 PM
2022/11/05,22:18,54,4,2,6,2022/11/05 10:18:00 PM
2022/11/05,22:26,11,2,1,3,2022/11/05 10:26:00 PM
2022/11/05,22:29,47,4,0,4,2022/11/05 10:29:00 PM
2022/11/05,22:24,35,35,17,52,2022/11/05 10:24:00 PM
2022/11/05,22:33,69,1,0,1,2022/11/05 10:33:00 PM
2022/11/05,22:25,72,5,3,8,2022/11/05 10:25:00 PM
2022/11/05,22:34,77,2,0,2,2022/11/05 10:34:00 PM
2022/11/05,22:20,9,1,1,2,2022/11/05 10:20:00 PM
2022/11/05,22:28,14,14,3,17,2022/11/05 10:28:00 PM
2022/11/05,22:33,41,23,8,31,2022/11/05 10:33:00 PM
2022/11/05,22:30,1,7,6,13,2022/11/05 10:30:00 PM
2022/11/05,22:31,4,11,12,23,2022/11/05 10:31:00 PM
2022/11/05,22:21,87,1,0,1,2022/11/05 10:21:00 PM
2022/11/05,22:15,23,1,1,2,2022/11/05 10:15:00 PM
2022/11/05,22:22,20,2,2,4,2022/11/05 10:22:00 PM
2022/11/05,22:29,42,2,0,2,2022/11/05 10:29:00 PM
2022/11/05,22:23,79,14,10,24,2022/11/05 10:23:00 PM
2022/11/05,22:31,71,0,1,1,2022/11/05 10:31:00 PM
2022/11/05,22:17,61,2,6,8,2022/11/05 10:17:00 PM
2022/11/05,22:22,62,3,2,5,2022/11/05 10:22:00 PM
2022/11/05,22:18,37,2,15,17,2022/11/05 10:18:00 PM
2022/11/05,22:29,50,9,0,9,2022/11/05 10:29:00 PM
2022/11/05,22:25,24,1,7,8,2022/11/05 10:25:00 PM
2022/11/05,22:28,35,51,14,65,2022/11/05 10:28:00 PM
2022/11/05,22:25,59,2,5,7,2022/11/05 10:25:00 PM
2022/11/05,22:33,6,10,6,16,2022/11/05 10:33:00 PM
2022/11/05,22:28,23,0,8,8,2022/11/05 10:28:00 PM
2022/11/05,22:20,24,4,9,13,2022/11/05 10:20:00 PM
2022/11/05,22:25,84,1,14,15,2022/11/05 10:25:00 PM
2022/11/05,22:14,36,1,0,1,2022/11/05 10:14:00 PM
2022/11/05,22:15,30,7,6,13,2022/11/05 10:15:00 PM
2022/11/05,22:32,65,2,13,15,2022/11/05 10:32:00 PM
2022/11/05,22:11,36,4,1,5,2022/11/05 10:11:00 PM
2022/11/05,22:21,59,5,3,8,2022/11/05 10:21:00 PM
2022/11/05,22:27,11,1,0,1,2022/11/05 10:27:00 PM
2022/11/05,22:19,42,0,2,2,2022/11/05 10:19:00 PM
2022/11/05,22:27,45,2,9,11,2022/11/05 10:27:00 PM
2022/11/05,22:29,36,2,4,6,2022/11/05 10:29:00 PM
2022/11/05,22:30,68,2,1,3,2022/11/05 10:30:00 PM
2022/11/05,22:26,61,5,0,5,2022/11/05 10:26:00 PM
2022/11/05,22:22,8,2,0,2,2022/11/05 10:22:00 PM
2022/11/05,22:21,27,0,1,1,2022/11/05 10:21:00 PM
2022/11/05,22:23,3,10,16,26,2022/11/05 10:23:00 PM
2022/11/05,22:21,37,9,2,11,2022/11/05 10:21:00 PM
2022/11/05,22:20,37,11,9,20,2022/11/05 10:20:00 PM
2022/11/05,22:29,1,1,8,9,2022/11/05 10:29:00 PM
2022/11/05,22:24,62,0,4,4,2022/11/05 10:24:00 PM
2022/11/05,22:25,5,14,9,23,2022/11/05 10:25:00 PM
2022/11/05,22:29,41,20,19,39,2022/11/05 10:29:00 PM
2022/11/05,22:23,68,2,5,7,2022/11/05 10:23:00 PM
2022/11/05,22:23,23,6,0,6,2022/11/05 10:23:00 PM
2022/11/05,22:27,49,2,0,2,2022/11/05 10:27:00 PM
2022/11/05,22:28,29,56,5,61,2022/11/05 10:28:00 PM
2022/11/05,22:33,58,2,2,4,2022/11/05 10:33:00 PM
2022/11/05,22:19,35,42,23,65,2022/11/05 10:19:00 PM
2022/11/05,22:22,56,1,8,9,2022/11/05 10:22:00 PM
2022/11/05,22:14,48,0,2,2,2022/11/05 10:14:00 PM
2022/11/05,22:33,28,6,18,24,2022/11/05 10:33:00 PM
2022/11/05,22:24,72,6,8,14,2022/11/05 10:24:00 PM
2022/11/05,22:30,59,2,0,2,2022/11/05 10:30:00 PM
2022/11/05,22:27,4,11,12,23,2022/11/05 10:27:00 PM
2022/11/05,22:33,59,6,0,6,2022/11/05 10:33:00 PM
2022/11/05,22:31,51,1,0,1,2022/11/05 10:31:00 PM
2022/11/05,22:20,3,12,9,21,2022/11/05 10:20:00 PM
2022/11/05,22:32,27,2,0,2,2022/11/05 10:32:00 PM
2022/11/05,22:30,63,13,1,14,2022/11/05 10:30:00 PM
2022/11/05,22:34,66,15,9,24,2022/11/05 10:34:00 PM
2022/11/05,22:09,23,10,4,14,2022/11/05 10:09:00 PM
2022/11/05,22:19,23,0,1,1,2022/11/05 10:19:00 PM
2022/11/05,22:25,87,2,1,3,2022/11/05 10:25:00 PM
2022/11/05,22:26,87,2,0,2,2022/11/05 10:26:00 PM
2022/11/05,22:20,12,4,2,6,2022/11/05 10:20:00 PM
2022/11/05,22:29,24,3,6,9,2022/11/05 10:29:00 PM
2022/11/05,22:19,5,14,14,28,2022/11/05 10:19:00 PM
2022/11/05,22:32,67,4,0,4,2022/11/05 10:32:00 PM
2022/11/05,22:27,24,6,3,9,2022/11/05 10:27:00 PM
2022/11/05,22:32,87,1,1,2,2022/11/05 10:32:00 PM
2022/11/05,22:25,57,0,5,5,2022/11/05 10:25:00 PM
2022/11/05,22:30,29,16,20,36,2022/11/05 10:30:00 PM
2022/11/05,22:27,63,10,4,14,2022/11/05 10:27:00 PM
2022/11/05,22:20,5,9,12,21,2022/11/05 10:20:00 PM
2022/11/05,22:31,47,6,8,14,2022/11/05 10:31:00 PM
2022/11/05,22:29,87,1,2,3,2022/11/05 10:29:00 PM
2022/11/05,22:22,3,17,11,28,2022/11/05 10:22:00 PM
2022/11/05,22:27,42,0,1,1,2022/11/05 10:27:00 PM
2022/11/05,22:16,23,0,1,1,2022/11/05 10:16:00 PM
2022/11/05,22:29,49,3,0,3,2022/11/05 10:29:00 PM
2022/11/05,22:29,63,2,11,13,2022/11/05 10:29:00 PM
2022/11/05,22:19,28,0,33,33,2022/11/05 10:19:00 PM
2022/11/05,22:30,62,0,3,3,2022/11/05 10:30:00 PM
2022/11/05,22:19,37,13,1,14,2022/11/05 10:19:00 PM
2022/11/05,22:31,24,1,2,3,2022/11/05 10:31:00 PM
2022/11/05,22:26,58,3,6,9,2022/11/05 10:26:00 PM
2022/11/05,22:27,66,13,6,19,2022/11/05 10:27:00 PM
2022/11/05,22:21,35,54,25,79,2022/11/05 10:21:00 PM
2022/11/05,22:21,12,0,5,5,2022/11/05 10:21:00 PM
2022/11/05,22:19,63,2,2,4,2022/11/05 10:19:00 PM
2022/11/05,22:32,71,1,0,1,2022/11/05 10:32:00 PM
2022/11/05,22:23,35,53,19,72,2022/11/05 10:23:00 PM
2022/11/05,22:24,61,8,0,8,2022/11/05 10:24:00 PM
2022/11/05,22:33,14,8,1,9,2022/11/05 10:33:00 PM
2022/11/05,22:28,63,6,2,8,2022/11/05 10:28:00 PM
2022/11/05,22:26,23,0,4,4,2022/11/05 10:26:00 PM
2022/11/05,22:27,61,4,2,6,2022/11/05 10:27:00 PM
2022/11/05,22:24,43,3,0,3,2022/11/05 10:24:00 PM
2022/11/05,22:20,59,4,6,10,2022/11/05 10:20:00 PM
2022/11/05,22:32,62,0,5,5,2022/11/05 10:32:00 PM
2022/11/05,22:19,50,1,1,2,2022/11/05 10:19:00 PM
2022/11/05,22:25,19,10,4,14,2022/11/05 10:25:00 PM
2022/11/05,22:15,61,2,5,7,2022/11/05 10:15:00 PM
2022/11/05,22:19,9,2,0,2,2022/11/05 10:19:00 PM
2022/11/05,22:31,59,3,0,3,2022/11/05 10:31:00 PM
2022/11/05,22:31,54,5,1,6,2022/11/05 10:31:00 PM
2022/11/05,22:28,12,0,1,1,2022/11/05 10:28:00 PM
2022/11/05,22:27,77,1,0,1,2022/11/05 10:27:00 PM
2022/11/05,22:23,6,7,10,17,2022/11/05 10:23:00 PM
2022/11/05,22:34,6,15,6,21,2022/11/05 10:34:00 PM
2022/11/05,22:22,19,5,13,18,2022/11/05 10:22:00 PM
2022/11/05,22:31,67,6,4,10,2022/11/05 10:31:00 PM
2022/11/05,22:25,61,1,3,4,2022/11/05 10:25:00 PM
2022/11/05,22:33,63,15,0,15,2022/11/05 10:33:00 PM
2022/11/05,22:21,84,14,2,16,2022/11/05 10:21:00 PM
2022/11/05,22:25,3,11,15,26,2022/11/05 10:25:00 PM
2022/11/05,22:16,31,3,6,9,2022/11/05 10:16:00 PM
2022/11/05,22:27,2,0,2,2,2022/11/05 10:27:00 PM
2022/11/05,22:29,14,6,1,7,2022/11/05 10:29:00 PM
2022/11/05,22:20,51,1,0,1,2022/11/05 10:20:00 PM
2022/11/05,22:17,19,8,12,20,2022/11/05 10:17:00 PM
2022/11/05,22:33,3,19,13,32,2022/11/05 10:33:00 PM
2022/11/05,22:28,57,1,2,3,2022/11/05 10:28:00 PM
2022/11/05,22:30,20,4,0,4,2022/11/05 10:30:00 PM
2022/11/05,22:28,54,1,2,3,2022/11/05 10:28:00 PM
2022/11/05,22:25,63,5,0,5,2022/11/05 10:25:00 PM
2022/11/05,22:32,39,4,0,4,2022/11/05 10:32:00 PM
2022/11/05,22:25,18,0,4,4,2022/11/05 10:25:00 PM
2022/11/05,22:20,14,21,4,25,2022/11/05 10:20:00 PM
2022/11/05,22:20,42,2,0,2,2022/11/05 10:20:00 PM
2022/11/05,22:31,45,4,15,19,2022/11/05 10:31:00 PM
2022/11/05,22:30,84,11,4,15,2022/11/05 10:30:00 PM
2022/11/05,22:30,65,0,8,8,2022/11/05 10:30:00 PM
2022/11/05,22:20,69,2,0,2,2022/11/05 10:20:00 PM
2022/11/05,22:25,23,2,2,4,2022/11/05 10:25:00 PM
2022/11/05,22:27,47,0,15,15,2022/11/05 10:27:00 PM
2022/11/05,22:23,18,1,0,1,2022/11/05 10:23:00 PM
2022/11/05,22:27,56,4,3,7,2022/11/05 10:27:00 PM
2022/11/05,22:26,66,6,1,7,2022/11/05 10:26:00 PM
2022/11/05,22:24,48,3,0,3,2022/11/05 10:24:00 PM
2022/11/05,22:27,51,3,3,6,2022/11/05 10:27:00 PM
2022/11/05,22:26,2,4,0,4,2022/11/05 10:26:00 PM
2022/11/05,22:22,27,0,3,3,2022/11/05 10:22:00 PM
2022/11/05,22:28,58,3,0,3,2022/11/05 10:28:00 PM
2022/11/05,22:21,36,8,8,16,2022/11/05 10:21:00 PM
2022/11/05,22:25,2,0,7,7,2022/11/05 10:25:00 PM
2022/11/05,22:30,77,2,1,3,2022/11/05 10:30:00 PM
2022/11/05,22:26,42,2,0,2,2022/11/05 10:26:00 PM
2022/11/05,22:22,66,8,12,20,2022/11/05 10:22:00 PM
2022/11/05,22:29,70,1,0,1,2022/11/05 10:29:00 PM
2022/11/05,22:24,3,22,25,47,2022/11/05 10:24:00 PM
2022/11/05,22:21,41,7,20,27,2022/11/05 10:21:00 PM
2022/11/05,22:31,77,1,0,1,2022/11/05 10:31:00 PM
2022/11/05,22:23,41,21,12,33,2022/11/05 10:23:00 PM
2022/11/05,22:27,69,1,0,1,2022/11/05 10:27:00 PM
2022/11/05,22:21,5,7,10,17,2022/11/05 10:21:00 PM
2022/11/05,22:21,8,5,3,8,2022/11/05 10:21:00 PM
2022/11/05,22:29,45,5,7,12,2022/11/05 10:29:00 PM
2022/11/05,22:33,47,10,5,15,2022/11/05 10:33:00 PM
2022/11/05,22:26,20,11,10,21,2022/11/05 10:26:00 PM
2022/11/05,22:24,65,3,1,4,2022/11/05 10:24:00 PM
2022/11/05,22:21,47,3,6,9,2022/11/05 10:21:00 PM
2022/11/05,22:19,87,3,0,3,2022/11/05 10:19:00 PM
2022/11/05,22:23,21,18,12,30,2022/11/05 10:23:00 PM
2022/11/05,22:24,20,4,2,6,2022/11/05 10:24:00 PM
2022/11/05,22:19,56,8,7,15,2022/11/05 10:19:00 PM
2022/11/05,22:21,31,10,3,13,2022/11/05 10:21:00 PM
2022/11/05,22:20,18,0,3,3,2022/11/05 10:20:00 PM
2022/11/05,22:18,47,9,13,22,2022/11/05 10:18:00 PM
2022/11/05,22:24,36,1,0,1,2022/11/05 10:24:00 PM
2022/11/05,22:20,84,9,16,25,2022/11/05 10:20:00 PM
2022/11/05,22:28,72,10,12,22,2022/11/05 10:28:00 PM
2022/11/05,22:32,54,1,3,4,2022/11/05 10:32:00 PM
2022/11/05,22:20,21,6,6,12,2022/11/05 10:20:00 PM
2022/11/05,22:29,72,3,14,17,2022/11/05 10:29:00 PM
2022/11/05,22:22,63,2,7,9,2022/11/05 10:22:00 PM
2022/11/05,22:26,24,4,2,6,2022/11/05 10:26:00 PM
2022/11/05,22:22,12,4,3,7,2022/11/05 10:22:00 PM
2022/11/05,22:15,37,2,7,9,2022/11/05 10:15:00 PM
2022/11/05,22:21,23,4,0,4,2022/11/05 10:21:00 PM
2022/11/05,22:28,67,3,1,4,2022/11/05 10:28:00 PM
2022/11/05,22:24,51,0,6,6,2022/11/05 10:24:00 PM
2022/11/05,22:32,12,0,6,6,2022/11/05 10:32:00 PM
2022/11/05,22:30,6,21,10,31,2022/11/05 10:30:00 PM
2022/11/05,22:30,35,14,20,34,2022/11/05 10:30:00 PM
2022/11/05,22:28,87,0,3,3,2022/11/05 10:28:00 PM
2022/11/05,22:20,79,2,3,5,2022/11/05 10:20:00 PM
2022/11/05,22:28,56,5,3,8,2022/11/05 10:28:00 PM
2022/11/05,22:27,14,1,3,4,2022/11/05 10:27:00 PM
2022/11/05,22:31,12,0,5,5,2022/11/05 10:31:00 PM
2022/11/05,22:26,69,0,1,1,2022/11/05 10:26:00 PM
2022/11/05,22:28,20,21,5,26,2022/11/05 10:28:00 PM
2022/11/05,22:31,28,5,21,26,2022/11/05 10:31:00 PM
2022/11/05,22:33,1,6,7,13,2022/11/05 10:33:00 PM
2022/11/05,22:23,36,3,3,6,2022/11/05 10:23:00 PM
2022/11/05,22:32,76,1,0,1,2022/11/05 10:32:00 PM
2022/11/05,22:31,36,2,3,5,2022/11/05 10:31:00 PM
2022/11/05,22:20,62,0,4,4,2022/11/05 10:20:00 PM
2022/11/05,22:16,21,18,12,30,2022/11/05 10:16:00 PM
2022/11/05,22:26,56,5,4,9,2022/11/05 10:26:00 PM
2022/11/05,22:32,45,2,10,12,2022/11/05 10:32:00 PM
2022/11/05,22:26,70,0,2,2,2022/11/05 10:26:00 PM
2022/11/05,22:27,54,0,1,1,2022/11/05 10:27:00 PM
2022/11/05,22:24,46,2,2,4,2022/11/05 10:24:00 PM
2022/11/05,22:22,72,1,3,4,2022/11/05 10:22:00 PM
2022/11/05,22:21,19,6,6,12,2022/11/05 10:21:00 PM
2022/11/05,22:32,18,1,0,1,2022/11/05 10:32:00 PM
2022/11/05,22:23,8,1,0,1,2022/11/05 10:23:00 PM
2022/11/05,22:23,65,1,11,12,2022/11/05 10:23:00 PM
2022/11/05,22:24,59,1,5,6,2022/11/05 10:24:00 PM
2022/11/05,22:13,36,0,7,7,2022/11/05 10:13:00 PM
2022/11/05,22:31,50,1,2,3,2022/11/05 10:31:00 PM
2022/11/05,22:21,18,2,0,2,2022/11/05 10:21:00 PM
2022/11/05,22:19,4,17,14,31,2022/11/05 10:19:00 PM
2022/11/05,22:29,6,11,16,27,2022/11/05 10:29:00 PM
2022/11/05,22:23,31,8,7,15,2022/11/05 10:23:00 PM
2022/11/05,22:21,6,8,11,19,2022/11/05 10:21:00 PM
2022/11/05,22:22,24,0,6,6,2022/11/05 10:22:00 PM
2022/11/05,22:21,68,4,12,16,2022/11/05 10:21:00 PM
2022/11/05,22:23,24,1,3,4,2022/11/05 10:23:00 PM
2022/11/05,22:17,40,0,3,3,2022/11/05 10:17:00 PM
2022/11/05,22:24,2,2,0,2,2022/11/05 10:24:00 PM
2022/11/05,22:28,70,0,2,2,2022/11/05 10:28:00 PM
2022/11/05,22:27,79,9,6,15,2022/11/05 10:27:00 PM
2022/11/05,22:19,30,17,3,20,2022/11/05 10:19:00 PM
2022/11/05,22:24,5,3,8,11,2022/11/05 10:24:00 PM
2022/11/05,22:15,19,5,3,8,2022/11/05 10:15:00 PM
2022/11/05,22:19,61,11,6,17,2022/11/05 10:19:00 PM
2022/11/05,22:28,47,14,15,29,2022/11/05 10:28:00 PM
2022/11/05,22:25,68,0,2,2,2022/11/05 10:25:00 PM
2022/11/05,22:19,67,5,3,8,2022/11/05 10:19:00 PM
2022/11/05,22:19,84,5,11,16,2022/11/05 10:19:00 PM
2022/11/05,22:29,40,2,0,2,2022/11/05 10:29:00 PM
2022/11/05,22:32,1,1,5,6,2022/11/05 10:32:00 PM
2022/11/05,22:31,3,7,9,16,2022/11/05 10:31:00 PM
2022/11/05,22:29,65,2,11,13,2022/11/05 10:29:00 PM
2022/11/05,22:34,79,6,1,7,2022/11/05 10:34:00 PM
2022/11/05,22:27,59,7,1,8,2022/11/05 10:27:00 PM
2022/11/05,22:21,43,0,1,1,2022/11/05 10:21:00 PM
2022/11/05,22:33,18,0,3,3,2022/11/05 10:33:00 PM
2022/11/05,22:19,21,8,4,12,2022/11/05 10:19:00 PM
2022/11/05,22:33,24,8,5,13,2022/11/05 10:33:00 PM
2022/11/05,22:25,30,6,23,29,2022/11/05 10:25:00 PM
2022/11/05,22:27,58,3,4,7,2022/11/05 10:27:00 PM
2022/11/05,22:32,84,9,15,24,2022/11/05 10:32:00 PM
2022/11/05,22:21,62,1,5,6,2022/11/05 10:21:00 PM
2022/11/05,22:32,56,3,0,3,2022/11/05 10:32:00 PM
2022/11/05,22:30,58,0,2,2,2022/11/05 10:30:00 PM
2022/11/05,22:22,41,10,5,15,2022/11/05 10:22:00 PM
2022/11/05,22:26,54,3,3,6,2022/11/05 10:26:00 PM
2022/11/05,22:25,49,0,3,3,2022/11/05 10:25:00 PM
2022/11/05,22:32,10,1,0,1,2022/11/05 10:32:00 PM
2022/11/05,22:22,50,8,1,9,2022/11/05 10:22:00 PM
2022/11/05,22:11,23,0,2,2,2022/11/05 10:11:00 PM
2022/11/05,22:25,1,8,3,11,2022/11/05 10:25:00 PM
2022/11/05,22:21,86,3,0,3,2022/11/05 10:21:00 PM
2022/11/05,22:25,44,2,0,2,2022/11/05 10:25:00 PM
2022/11/05,22:29,46,1,0,1,2022/11/05 10:29:00 PM
2022/11/05,22:33,62,1,0,1,2022/11/05 10:33:00 PM
2022/11/05,22:14,23,7,1,8,2022/11/05 10:14:00 PM
2022/11/05,22:20,23,0,1,1,2022/11/05 10:20:00 PM
2022/11/05,22:31,42,2,2,4,2022/11/05 10:31:00 PM
2022/11/05,22:23,66,22,9,31,2022/11/05 10:23:00 PM
2022/11/05,22:29,30,12,7,19,2022/11/05 10:29:00 PM
2022/11/05,22:33,65,12,1,13,2022/11/05 10:33:00 PM
2022/11/05,22:26,18,0,1,1,2022/11/05 10:26:00 PM
2022/11/05,22:32,70,1,0,1,2022/11/05 10:32:00 PM
2022/11/05,22:19,24,2,2,4,2022/11/05 10:19:00 PM
2022/11/05,22:28,30,12,13,25,2022/11/05 10:28:00 PM
2022/11/05,22:21,79,2,1,3,2022/11/05 10:21:00 PM
2022/11/05,22:23,29,29,2,31,2022/11/05 10:23:00 PM
2022/11/05,22:32,51,0,1,1,2022/11/05 10:32:00 PM
2022/11/05,22:29,5,5,8,13,2022/11/05 10:29:00 PM
2022/11/05,22:30,41,9,18,27,2022/11/05 10:30:00 PM
2022/11/05,22:30,79,6,6,12,2022/11/05 10:30:00 PM
2022/11/05,22:20,57,0,2,2,2022/11/05 10:20:00 PM
2022/11/05,22:19,70,0,3,3,2022/11/05 10:19:00 PM
2022/11/05,22:22,69,2,0,2,2022/11/05 10:22:00 PM
2022/11/05,22:27,72,4,7,11,2022/11/05 10:27:00 PM
2022/11/05,22:21,11,3,0,3,2022/11/05 10:21:00 PM
2022/11/05,22:22,65,5,9,14,2022/11/05 10:22:00 PM
2022/11/05,22:24,79,6,3,9,2022/11/05 10:24:00 PM
2022/11/05,22:19,45,0,10,10,2022/11/05 10:19:00 PM
2022/11/05,22:31,6,12,5,17,2022/11/05 10:31:00 PM
2022/11/05,22:23,1,3,4,7,2022/11/05 10:23:00 PM
2022/11/05,22:30,14,3,2,5,2022/11/05 10:30:00 PM
2022/11/05,22:27,30,10,6,16,2022/11/05 10:27:00 PM
2022/11/05,22:25,40,2,0,2,2022/11/05 10:25:00 PM
2022/11/05,22:14,40,1,1,2,2022/11/05 10:14:00 PM
2022/11/05,22:22,68,1,2,3,2022/11/05 10:22:00 PM
2022/11/05,22:26,51,0,6,6,2022/11/05 10:26:00 PM
2022/11/05,22:22,61,1,6,7,2022/11/05 10:22:00 PM
2022/11/05,22:30,56,0,10,10,2022/11/05 10:30:00 PM
2022/11/05,22:31,84,7,8,15,2022/11/05 10:31:00 PM
2022/11/05,22:29,66,10,6,16,2022/11/05 10:29:00 PM
2022/11/05,22:20,56,3,5,8,2022/11/05 10:20:00 PM
2022/11/05,22:24,1,8,2,10,2022/11/05 10:24:00 PM
2022/11/05,22:20,11,0,1,1,2022/11/05 10:20:00 PM
2022/11/05,22:29,77,0,3,3,2022/11/05 10:29:00 PM
2022/11/05,22:23,27,6,0,6,2022/11/05 10:23:00 PM
2022/11/05,22:30,18,0,2,2,2022/11/05 10:30:00 PM
2022/11/05,22:21,63,5,3,8,2022/11/05 10:21:00 PM
2022/11/05,22:31,72,9,8,17,2022/11/05 10:31:00 PM
2022/11/05,22:19,58,5,0,5,2022/11/05 10:19:00 PM
2022/11/05,22:27,20,5,1,6,2022/11/05 10:27:00 PM
2022/11/05,22:25,70,1,0,1,2022/11/05 10:25:00 PM
2022/11/05,22:19,20,7,12,19,2022/11/05 10:19:00 PM
2022/11/05,22:26,35,34,35,69,2022/11/05 10:26:00 PM
2022/11/05,22:33,42,1,2,3,2022/11/05 10:33:00 PM
2022/11/05,22:30,66,5,4,9,2022/11/05 10:30:00 PM
2022/11/05,22:27,39,1,1,2,2022/11/05 10:27:00 PM
2022/11/05,22:30,30,12,3,15,2022/11/05 10:30:00 PM
2022/11/05,22:33,68,0,2,2,2022/11/05 10:33:00 PM
2022/11/05,22:25,54,1,1,2,2022/11/05 10:25:00 PM
2022/11/05,22:20,30,14,2,16,2022/11/05 10:20:00 PM
2022/11/05,22:24,58,2,3,5,2022/11/05 10:24:00 PM
2022/11/05,22:22,2,2,4,6,2022/11/05 10:22:00 PM
2022/11/05,22:21,66,6,7,13,2022/11/05 10:21:00 PM
2022/11/05,22:33,2,5,0,5,2022/11/05 10:33:00 PM
2022/11/05,22:15,31,2,7,9,2022/11/05 10:15:00 PM
2022/11/05,22:20,45,2,15,17,2022/11/05 10:20:00 PM
2022/11/05,22:30,48,2,0,2,2022/11/05 10:30:00 PM
2022/11/05,22:22,6,17,21,38,2022/11/05 10:22:00 PM
2022/11/05,22:33,35,29,21,50,2022/11/05 10:33:00 PM
2022/11/05,22:29,2,0,2,2,2022/11/05 10:29:00 PM
2022/11/05,22:26,36,1,2,3,2022/11/05 10:26:00 PM
2022/11/05,22:31,43,0,1,1,2022/11/05 10:31:00 PM
2022/11/05,22:32,14,8,3,11,2022/11/05 10:32:00 PM
2022/11/05,22:32,69,0,4,4,2022/11/05 10:32:00 PM
2022/11/05,22:30,70,2,0,2,2022/11/05 10:30:00 PM
2022/11/05,22:29,56,10,3,13,2022/11/05 10:29:00 PM
2022/11/05,22:20,2,2,7,9,2022/11/05 10:20:00 PM
2022/11/05,22:18,5,10,22,32,2022/11/05 10:18:00 PM
2022/11/05,22:25,65,8,11,19,2022/11/05 10:25:00 PM
2022/11/05,22:29,28,2,25,27,2022/11/05 10:29:00 PM
2022/11/05,22:26,65,2,3,5,2022/11/05 10:26:00 PM
2022/11/05,22:23,84,5,14,19,2022/11/05 10:23:00 PM
2022/11/05,22:22,5,11,13,24,2022/11/05 10:22:00 PM
2022/11/05,22:22,10,1,0,1,2022/11/05 10:22:00 PM
2022/11/05,22:24,30,7,2,9,2022/11/05 10:24:00 PM
2022/11/05,22:33,27,1,1,2,2022/11/05 10:33:00 PM
2022/11/05,22:34,72,5,9,14,2022/11/05 10:34:00 PM
2022/11/05,22:19,11,3,1,4,2022/11/05 10:19:00 PM
2022/11/05,22:33,87,0,1,1,2022/11/05 10:33:00 PM
2022/11/05,22:33,72,0,7,7,2022/11/05 10:33:00 PM
2022/11/05,22:29,62,1,5,6,2022/11/05 10:29:00 PM
2022/11/05,22:32,29,22,6,28,2022/11/05 10:32:00 PM
2022/11/05,22:23,10,2,0,2,2022/11/05 10:23:00 PM
2022/11/05,22:24,50,1,1,2,2022/11/05 10:24:00 PM
2022/11/05,22:29,4,26,5,31,2022/11/05 10:29:00 PM
2022/11/05,22:31,66,6,4,10,2022/11/05 10:31:00 PM
2022/11/05,22:24,27,0,1,1,2022/11/05 10:24:00 PM
2022/11/05,22:26,14,4,3,7,2022/11/05 10:26:00 PM
2022/11/05,22:18,30,11,1,12,2022/11/05 10:18:00 PM
2022/11/05,22:13,43,1,0,1,2022/11/05 10:13:00 PM
2022/11/05,22:16,46,1,0,1,2022/11/05 10:16:00 PM
2022/11/05,22:24,19,13,3,16,2022/11/05 10:24:00 PM
2022/11/05,22:26,48,0,2,2,2022/11/05 10:26:00 PM
2022/11/05,22:18,31,9,7,16,2022/11/05 10:18:00 PM
2022/11/05,22:32,24,0,3,3,2022/11/05 10:32:00 PM
2022/11/05,22:18,21,24,6,30,2022/11/05 10:18:00 PM
2022/11/05,22:31,41,9,17,26,2022/11/05 10:31:00 PM
2022/11/05,22:28,68,0,2,2,2022/11/05 10:28:00 PM
2022/11/05,22:21,1,5,5,10,2022/11/05 10:21:00 PM
2022/11/05,22:29,27,3,0,3,2022/11/05 10:29:00 PM
2022/11/05,22:27,27,0,2,2,2022/11/05 10:27:00 PM
2022/11/05,22:25,29,18,6,24,2022/11/05 10:25:00 PM
2022/11/05,22:10,44,1,0,1,2022/11/05 10:10:00 PM
2022/11/05,22:12,36,1,0,1,2022/11/05 10:12:00 PM
2022/11/05,22:30,72,2,13,15,2022/11/05 10:30:00 PM
2022/11/05,22:27,6,10,9,19,2022/11/05 10:27:00 PM
2022/11/05,22:34,84,9,14,23,2022/11/05 10:34:00 PM
2022/11/05,22:27,10,0,3,3,2022/11/05 10:27:00 PM
2022/11/05,22:32,63,19,5,24,2022/11/05 10:32:00 PM
2022/11/05,22:21,61,0,4,4,2022/11/05 10:21:00 PM
2022/11/05,22:27,46,1,0,1,2022/11/05 10:27:00 PM
2022/11/05,22:32,72,2,2,4,2022/11/05 10:32:00 PM
2022/11/05,22:14,31,5,4,9,2022/11/05 10:14:00 PM
2022/11/05,22:31,49,1,0,1,2022/11/05 10:31:00 PM
2022/11/05,22:25,48,1,0,1,2022/11/05 10:25:00 PM
2022/11/05,22:16,30,10,7,17,2022/11/05 10:16:00 PM
2022/11/05,22:26,59,1,1,2,2022/11/05 10:26:00 PM
2022/11/05,22:27,65,1,11,12,2022/11/05 10:27:00 PM
2022/11/05,22:24,63,2,6,8,2022/11/05 10:24:00 PM
2022/11/05,22:22,36,3,2,5,2022/11/05 10:22:00 PM
2022/11/05,22:17,5,16,15,31,2022/11/05 10:17:00 PM
2022/11/05,22:26,29,49,15,64,2022/11/05 10:26:00 PM
2022/11/05,22:28,65,0,10,10,2022/11/05 10:28:00 PM
2022/11/05,22:34,70,1,0,1,2022/11/05 10:34:00 PM
2022/11/05,22:32,28,4,3,7,2022/11/05 10:32:00 PM
2022/11/05,22:23,45,3,10,13,2022/11/05 10:23:00 PM
2022/11/05,22:30,50,2,1,3,2022/11/05 10:30:00 PM
2022/11/05,22:24,14,5,3,8,2022/11/05 10:24:00 PM
2022/11/05,22:25,27,0,2,2,2022/11/05 10:25:00 PM
2022/11/05,22:25,47,8,2,10,2022/11/05 10:25:00 PM
2022/11/05,22:25,66,14,13,27,2022/11/05 10:25:00 PM
2022/11/05,22:19,1,4,3,7,2022/11/05 10:19:00 PM
2022/11/05,22:28,40,2,0,2,2022/11/05 10:28:00 PM
2022/11/05,22:19,41,28,6,34,2022/11/05 10:19:00 PM
2022/11/05,22:24,47,11,11,22,2022/11/05 10:24:00 PM
2022/11/05,22:22,21,12,7,19,2022/11/05 10:22:00 PM
2022/11/05,22:17,36,0,3,3,2022/11/05 10:17:00 PM
2022/11/05,22:28,45,3,12,15,2022/11/05 10:28:00 PM
2022/11/05,22:18,48,0,1,1,2022/11/05 10:18:00 PM
2022/11/05,22:29,86,0,1,1,2022/11/05 10:29:00 PM
2022/11/05,22:19,19,6,11,17,2022/11/05 10:19:00 PM
2022/11/05,22:18,46,2,0,2,2022/11/05 10:18:00 PM
2022/11/05,22:33,66,5,12,17,2022/11/05 10:33:00 PM
2022/11/05,22:19,62,1,0,1,2022/11/05 10:19:00 PM
2022/11/05,22:22,59,5,2,7,2022/11/05 10:22:00 PM
2022/11/05,22:28,39,2,4,6,2022/11/05 10:28:00 PM
2022/11/05,22:32,79,6,5,11,2022/11/05 10:32:00 PM
2022/11/05,22:30,42,7,0,7,2022/11/05 10:30:00 PM
2022/11/05,22:25,41,23,11,34,2022/11/05 10:25:00 PM
2022/11/05,22:17,31,2,2,4,2022/11/05 10:17:00 PM
2022/11/05,22:29,59,3,1,4,2022/11/05 10:29:00 PM
2022/11/05,22:20,67,3,0,3,2022/11/05 10:20:00 PM
2022/11/05,22:15,36,3,1,4,2022/11/05 10:15:00 PM
2022/11/05,22:24,37,6,6,12,2022/11/05 10:24:00 PM
2022/11/05,22:20,61,5,4,9,2022/11/05 10:20:00 PM
2022/11/05,22:22,77,2,0,2,2022/11/05 10:22:00 PM
2022/11/05,22:25,21,7,5,12,2022/11/05 10:25:00 PM
2022/11/05,22:29,48,0,4,4,2022/11/05 10:29:00 PM
2022/11/05,22:18,40,3,2,5,2022/11/05 10:18:00 PM
2022/11/05,22:23,67,1,1,2,2022/11/05 10:23:00 PM
2022/11/05,22:33,9,1,0,1,2022/11/05 10:33:00 PM
2022/11/05,22:20,19,20,2,22,2022/11/05 10:20:00 PM
2022/11/05,22:26,12,2,1,3,2022/11/05 10:26:00 PM
2022/11/05,22:26,49,3,0,3,2022/11/05 10:26:00 PM
2022/11/05,22:33,70,2,0,2,2022/11/05 10:33:00 PM
2022/11/05,22:16,44,1,0,1,2022/11/05 10:16:00 PM
2022/11/05,22:18,36,0,9,9,2022/11/05 10:18:00 PM
2022/11/05,22:25,12,1,6,7,2022/11/05 10:25:00 PM
2022/11/05,22:23,54,2,0,2,2022/11/05 10:23:00 PM
2022/11/05,22:30,49,0,6,6,2022/11/05 10:30:00 PM
2022/11/05,22:32,41,8,14,22,2022/11/05 10:32:00 PM
2022/11/05,22:25,45,5,10,15,2022/11/05 10:25:00 PM
2022/11/05,22:22,31,12,3,15,2022/11/05 10:22:00 PM
2022/11/05,22:28,27,0,1,1,2022/11/05 10:28:00 PM
2022/11/05,22:19,54,0,1,1,2022/11/05 10:19:00 PM
2022/11/05,22:22,67,8,6,14,2022/11/05 10:22:00 PM
2022/11/05,22:32,59,4,3,7,2022/11/05 10:32:00 PM
2022/11/05,22:18,45,2,8,10,2022/11/05 10:18:00 PM
2022/11/05,22:32,47,12,11,23,2022/11/05 10:32:00 PM
2022/11/05,22:33,84,16,15,31,2022/11/05 10:33:00 PM
2022/11/05,22:23,28,2,22,24,2022/11/05 10:23:00 PM
2022/11/05,22:27,5,15,13,28,2022/11/05 10:27:00 PM
2022/11/05,22:29,35,21,11,32,2022/11/05 10:29:00 PM
2022/11/05,22:25,77,1,3,4,2022/11/05 10:25:00 PM
2022/11/05,22:28,49,1,0,1,2022/11/05 10:28:00 PM
2022/11/05,22:22,45,4,3,7,2022/11/05 10:22:00 PM
2022/11/05,22:14,44,2,0,2,2022/11/05 10:14:00 PM
2022/11/05,22:34,29,14,3,17,2022/11/05 10:34:00 PM
2022/11/05,22:27,50,8,1,9,2022/11/05 10:27:00 PM
2022/11/05,22:27,41,8,14,22,2022/11/05 10:27:00 PM
2022/11/05,22:31,14,9,2,11,2022/11/05 10:31:00 PM
2022/11/05,22:18,58,5,9,14,2022/11/05 10:18:00 PM
2022/11/05,22:26,79,11,6,17,2022/11/05 10:26:00 PM
2022/11/05,22:27,3,25,17,42,2022/11/05 10:27:00 PM
2022/11/05,22:34,14,4,1,5,2022/11/05 10:34:00 PM
2022/11/05,22:26,76,2,0,2,2022/11/05 10:26:00 PM
2022/11/05,22:23,51,0,2,2,2022/11/05 10:23:00 PM
2022/11/05,22:23,56,3,1,4,2022/11/05 10:23:00 PM
2022/11/05,22:24,66,6,3,9,2022/11/05 10:24:00 PM
2022/11/05,22:24,29,35,4,39,2022/11/05 10:24:00 PM
2022/11/05,22:24,41,10,2,12,2022/11/05 10:24:00 PM
2022/11/05,22:18,19,14,12,26,2022/11/05 10:18:00 PM
2022/11/05,22:28,84,8,4,12,2022/11/05 10:28:00 PM
2022/11/05,22:19,2,7,1,8,2022/11/05 10:19:00 PM
2022/11/05,22:29,54,3,2,5,2022/11/05 10:29:00 PM
2022/11/05,22:19,68,2,6,8,2022/11/05 10:19:00 PM
2022/11/05,22:27,23,0,2,2,2022/11/05 10:27:00 PM
2022/11/05,22:22,46,3,3,6,2022/11/05 10:22:00 PM
2022/11/05,22:32,8,2,0,2,2022/11/05 10:32:00 PM
2022/11/05,22:26,72,3,10,13,2022/11/05 10:26:00 PM
2022/11/05,22:24,45,4,1,5,2022/11/05 10:24:00 PM
2022/11/05,22:15,48,4,6,10,2022/11/05 10:15:00 PM
2022/11/05,22:20,35,45,18,63,2022/11/05 10:20:00 PM
2022/11/05,22:21,30,8,7,15,2022/11/05 10:21:00 PM
2022/11/05,22:21,48,2,1,3,2022/11/05 10:21:00 PM
2022/11/05,22:22,84,13,9,22,2022/11/05 10:22:00 PM
2022/11/05,22:21,14,11,0,11,2022/11/05 10:21:00 PM
2022/11/05,22:26,1,4,3,7,2022/11/05 10:26:00 PM
2022/11/05,22:28,1,2,2,4,2022/11/05 10:28:00 PM
2022/11/05,22:30,4,10,22,32,2022/11/05 10:30:00 PM
2022/11/05,22:26,50,2,1,3,2022/11/05 10:26:00 PM
2022/11/05,22:27,84,6,3,9,2022/11/05 10:27:00 PM
2022/11/05,22:32,50,0,4,4,2022/11/05 10:32:00 PM
2022/11/05,22:33,39,1,3,4,2022/11/05 10:33:00 PM
2022/11/05,22:20,28,4,20,24,2022/11/05 10:20:00 PM
2022/11/05,22:21,45,4,4,8,2022/11/05 10:21:00 PM
2022/11/05,22:29,18,3,0,3,2022/11/05 10:29:00 PM
2022/11/05,22:24,56,0,4,4,2022/11/05 10:24:00 PM
2022/11/05,22:25,50,1,5,6,2022/11/05 10:25:00 PM
2022/11/05,22:16,36,0,2,2,2022/11/05 10:16:00 PM
2022/11/05,22:24,10,0,1,1,2022/11/05 10:24:00 PM
2022/11/05,22:23,70,0,2,2,2022/11/05 10:23:00 PM
2022/11/05,22:23,58,1,2,3,2022/11/05 10:23:00 PM
2022/11/05,22:18,61,1,1,2,2022/11/05 10:18:00 PM
2022/11/05,22:20,48,1,0,1,2022/11/05 10:20:00 PM
2022/11/05,22:25,28,4,50,54,2022/11/05 10:25:00 PM
2022/11/05,22:16,37,4,17,21,2022/11/05 10:16:00 PM
2022/11/05,22:20,65,1,8,9,2022/11/05 10:20:00 PM
2022/11/05,22:21,39,1,0,1,2022/11/05 10:21:00 PM
2022/11/05,22:23,19,12,2,14,2022/11/05 10:23:00 PM
2022/11/05,22:22,47,6,13,19,2022/11/05 10:22:00 PM
2022/11/05,22:31,58,3,1,4,2022/11/05 10:31:00 PM
2022/11/05,22:20,50,7,6,13,2022/11/05 10:20:00 PM
2022/11/05,22:21,21,14,9,23,2022/11/05 10:21:00 PM
2022/11/05,22:30,24,3,9,12,2022/11/05 10:30:00 PM
2022/11/05,22:16,57,2,1,3,2022/11/05 10:16:00 PM
2022/11/05,22:21,58,2,3,5,2022/11/05 10:21:00 PM
2022/11/05,22:27,67,8,3,11,2022/11/05 10:27:00 PM
2022/11/05,22:26,6,23,9,32,2022/11/05 10:26:00 PM
2022/11/05,22:23,48,2,0,2,2022/11/05 10:23:00 PM
2022/11/05,22:20,77,0,1,1,2022/11/05 10:20:00 PM
2022/11/05,22:29,79,7,5,12,2022/11/05 10:29:00 PM
2022/11/05,22:25,6,14,18,32,2022/11/05 10:25:00 PM
2022/11/05,22:22,43,1,0,1,2022/11/05 10:22:00 PM
2022/11/05,22:28,41,26,18,44,2022/11/05 10:28:00 PM
2022/11/05,22:31,85,1,2,3,2022/11/05 10:31:00 PM
2022/11/05,22:31,68,1,3,4,2022/11/05 10:31:00 PM
2022/11/05,22:24,84,16,3,19,2022/11/05 10:24:00 PM
2022/11/05,22:21,85,1,0,1,2022/11/05 10:21:00 PM
2022/11/05,22:19,18,0,1,1,2022/11/05 10:19:00 PM
2022/11/05,22:19,31,7,9,16,2022/11/05 10:19:00 PM
2022/11/05,22:27,28,7,24,31,2022/11/05 10:27:00 PM
2022/11/05,22:19,65,6,9,15,2022/11/05 10:19:00 PM
2022/11/05,22:29,39,0,1,1,2022/11/05 10:29:00 PM
2022/11/05,22:30,12,0,5,5,2022/11/05 10:30:00 PM
2022/11/05,22:28,18,2,1,3,2022/11/05 10:28:00 PM
2022/11/05,22:23,47,2,6,8,2022/11/05 10:23:00 PM
2022/11/05,22:23,59,2,4,6,2022/11/05 10:23:00 PM
2022/11/05,22:16,5,13,27,40,2022/11/05 10:16:00 PM
2022/11/05,22:19,3,7,21,28,2022/11/05 10:19:00 PM
2022/11/05,22:22,28,4,43,47,2022/11/05 10:22:00 PM
2022/11/05,22:24,49,1,1,2,2022/11/05 10:24:00 PM
2022/11/05,22:33,29,22,8,30,2022/11/05 10:33:00 PM
2022/11/05,22:27,29,28,11,39,2022/11/05 10:27:00 PM
2022/11/05,22:13,23,4,0,4,2022/11/05 10:13:00 PM
2022/11/05,22:33,12,3,0,3,2022/11/05 10:33:00 PM
2022/11/05,22:24,31,10,17,27,2022/11/05 10:24:00 PM
2022/11/05,22:29,3,3,9,12,2022/11/05 10:29:00 PM
2022/11/05,22:28,9,0,1,1,2022/11/05 10:28:00 PM
2022/11/05,22:22,58,5,7,12,2022/11/05 10:22:00 PM
2022/11/05,22:17,48,1,0,1,2022/11/05 10:17:00 PM
2022/11/05,22:26,41,24,17,41,2022/11/05 10:26:00 PM
2022/11/05,22:22,14,11,2,13,2022/11/05 10:22:00 PM
2022/11/05,22:23,40,0,2,2,2022/11/05 10:23:00 PM
2022/11/05,22:26,47,11,7,18,2022/11/05 10:26:00 PM
2022/11/05,22:31,10,0,2,2,2022/11/05 10:31:00 PM
2022/11/05,22:25,4,14,15,29,2022/11/05 10:25:00 PM
2022/11/05,22:12,43,0,1,1,2022/11/05 10:12:00 PM
2022/11/05,22:25,67,2,7,9,2022/11/05 10:25:00 PM
2022/11/05,22:33,79,8,2,10,2022/11/05 10:33:00 PM
2022/11/05,22:28,79,0,7,7,2022/11/05 10:28:00 PM
2022/11/05,22:28,42,0,2,2,2022/11/05 10:28:00 PM
2022/11/05,22:22,54,4,3,7,2022/11/05 10:22:00 PM
2022/11/05,22:31,2,5,1,6,2022/11/05 10:31:00 PM
2022/11/05,22:27,8,6,2,8,2022/11/05 10:27:00 PM
2022/11/05,22:28,61,0,3,3,2022/11/05 10:28:00 PM
2022/11/05,22:26,27,0,2,2,2022/11/05 10:26:00 PM
2022/11/05,22:21,51,0,12,12,2022/11/05 10:21:00 PM
2022/11/05,22:23,4,9,14,23,2022/11/05 10:23:00 PM
2022/11/05,22:24,21,13,6,19,2022/11/05 10:24:00 PM
2022/11/05,22:20,40,2,0,2,2022/11/05 10:20:00 PM
2022/11/05,22:31,70,0,1,1,2022/11/05 10:31:00 PM
2022/11/05,22:23,12,2,1,3,2022/11/05 10:23:00 PM
2022/11/05,22:19,8,5,1,6,2022/11/05 10:19:00 PM
2022/11/05,22:29,67,6,6,12,2022/11/05 10:29:00 PM
2022/11/05,22:20,20,5,16,21,2022/11/05 10:20:00 PM
2022/11/05,22:32,3,14,5,19,2022/11/05 10:32:00 PM
2022/11/05,22:22,44,0,1,1,2022/11/05 10:22:00 PM
2022/11/05,22:17,37,7,9,16,2022/11/05 10:17:00 PM
2022/11/05,22:26,30,8,4,12,2022/11/05 10:26:00 PM
2022/11/05,22:29,85,2,0,2,2022/11/05 10:29:00 PM
2022/11/05,22:31,79,14,2,16,2022/11/05 10:31:00 PM
2022/11/05,22:20,6,19,3,22,2022/11/05 10:20:00 PM
2022/11/05,22:20,29,19,3,22,2022/11/05 10:20:00 PM
2022/11/05,22:24,8,2,1,3,2022/11/05 10:24:00 PM
2022/11/05,22:27,87,2,0,2,2022/11/05 10:27:00 PM
2022/11/05,22:22,35,28,20,48,2022/11/05 10:22:00 PM
2022/11/05,22:23,62,0,2,2,2022/11/05 10:23:00 PM
2022/11/05,22:21,50,17,4,21,2022/11/05 10:21:00 PM
2022/11/05,22:28,50,3,0,3,2022/11/05 10:28:00 PM
2022/11/05,22:24,57,1,0,1,2022/11/05 10:24:00 PM
2022/11/05,22:28,77,1,3,4,2022/11/05 10:28:00 PM
2022/11/05,22:33,67,1,7,8,2022/11/05 10:33:00 PM
2022/11/05,22:29,51,1,2,3,2022/11/05 10:29:00 PM
2022/11/05,22:22,48,4,7,11,2022/11/05 10:22:00 PM
2022/11/05,22:19,57,0,3,3,2022/11/05 10:19:00 PM
2022/11/05,22:19,6,16,16,32,2022/11/05 10:19:00 PM
2022/11/05,22:31,35,20,17,37,2022/11/05 10:31:00 PM
2022/11/05,22:19,36,0,6,6,2022/11/05 10:19:00 PM
2022/11/05,22:20,86,1,0,1,2022/11/05 10:20:00 PM
2022/11/05,22:32,42,1,0,1,2022/11/05 10:32:00 PM
2022/11/05,22:33,8,0,1,1,2022/11/05 10:33:00 PM
2022/11/05,22:26,28,4,38,42,2022/11/05 10:26:00 PM
2022/11/05,22:23,20,5,10,15,2022/11/05 10:23:00 PM
2022/11/05,22:25,79,4,5,9,2022/11/05 10:25:00 PM
2022/11/05,22:24,6,11,9,20,2022/11/05 10:24:00 PM
2022/11/05,22:27,12,4,5,9,2022/11/05 10:27:00 PM
2022/11/05,22:21,67,1,3,4,2022/11/05 10:21:00 PM
2022/11/05,22:28,51,3,1,4,2022/11/05 10:28:00 PM
2022/11/05,22:33,56,3,4,7,2022/11/05 10:33:00 PM
2022/11/05,22:17,23,5,0,5,2022/11/05 10:17:00 PM
2022/11/05,22:30,51,1,0,1,2022/11/05 10:30:00 PM
2022/11/05,22:24,23,0,1,1,2022/11/05 10:24:00 PM
2022/11/05,22:32,6,16,2,18,2022/11/05 10:32:00 PM
2022/11/05,22:29,84,6,20,26,2022/11/05 10:29:00 PM
2022/11/05,22:27,70,1,1,2,2022/11/05 10:27:00 PM
2022/11/05,22:20,47,3,6,9,2022/11/05 10:20:00 PM
2022/11/05,22:25,58,0,3,3,2022/11/05 10:25:00 PM
2022/11/05,22:19,12,4,0,4,2022/11/05 10:19:00 PM
2022/11/05,22:22,4,5,13,18,2022/11/05 10:22:00 PM
2022/11/05,22:17,30,17,7,24,2022/11/05 10:17:00 PM
2022/11/05,22:22,1,3,7,10,2022/11/05 10:22:00 PM
2022/11/05,22:29,8,1,0,1,2022/11/05 10:29:00 PM
2022/11/05,22:20,63,7,8,15,2022/11/05 10:20:00 PM
2022/11/05,22:22,30,10,6,16,2022/11/05 10:22:00 PM
2022/11/05,22:24,40,5,0,5,2022/11/05 10:24:00 PM
2022/11/05,22:20,31,6,11,17,2022/11/05 10:20:00 PM
2022/11/05,22:30,28,1,18,19,2022/11/05 10:30:00 PM
2022/11/05,22:25,20,8,5,13,2022/11/05 10:25:00 PM
2022/11/05,22:29,20,9,4,13,2022/11/05 10:29:00 PM
2022/11/05,22:22,11,1,1,2,2022/11/05 10:22:00 PM
2022/11/05,22:25,36,2,6,8,2022/11/05 10:25:00 PM
2022/11/05,22:21,2,5,1,6,2022/11/05 10:21:00 PM
2022/11/05,22:21,20,6,1,7,2022/11/05 10:21:00 PM
2022/11/05,22:22,70,1,0,1,2022/11/05 10:22:00 PM
2022/11/05,22:28,59,6,6,12,2022/11/05 10:28:00 PM
2022/11/05,22:30,36,0,1,1,2022/11/05 10:30:00 PM
2022/11/05,22:23,63,7,2,9,2022/11/05 10:23:00 PM
2022/11/05,22:21,3,24,12,36,2022/11/05 10:21:00 PM
2022/11/05,22:23,72,6,6,12,2022/11/05 10:23:00 PM
2022/11/05,22:32,35,15,17,32,2022/11/05 10:32:00 PM
2022/11/05,22:16,19,7,4,11,2022/11/05 10:16:00 PM
2022/11/05,22:29,12,1,2,3,2022/11/05 10:29:00 PM
2022/11/05,22:25,46,0,1,1,2022/11/05 10:25:00 PM
2022/11/05,22:20,36,1,5,6,2022/11/05 10:20:00 PM
2022/11/05,22:22,51,1,2,3,2022/11/05 10:22:00 PM
2022/11/05,22:28,2,3,1,4,2022/11/05 10:28:00 PM
2022/11/05,22:21,9,2,0,2,2022/11/05 10:21:00 PM
2022/11/05,22:23,37,5,2,7,2022/11/05 10:23:00 PM
2022/11/05,22:28,8,1,0,1,2022/11/05 10:28:00 PM
2022/11/05,22:20,87,2,0,2,2022/11/05 10:20:00 PM
2022/11/05,22:26,3,0,18,18,2022/11/05 10:26:00 PM
2022/11/05,22:32,66,22,12,34,2022/11/05 10:32:00 PM
2022/11/05,22:24,12,3,1,4,2022/11/05 10:24:00 PM
2022/11/05,22:27,40,2,0,2,2022/11/05 10:27:00 PM
2022/11/05,22:28,3,12,7,19,2022/11/05 10:28:00 PM
2022/11/05,22:21,49,2,0,2,2022/11/05 10:21:00 PM
2022/11/05,22:14,30,12,12,24,2022/11/05 10:14:00 PM
2022/11/05,22:20,54,1,2,3,2022/11/05 10:20:00 PM
2022/11/05,22:28,24,32,2,34,2022/11/05 10:28:00 PM
2022/11/05,22:23,50,4,2,6,2022/11/05 10:23:00 PM
2022/11/05,22:21,72,5,12,17,2022/11/05 10:21:00 PM
2022/11/05,22:34,59,1,2,3,2022/11/05 10:34:00 PM
2022/11/05,22:32,2,4,0,4,2022/11/05 10:32:00 PM
2022/11/05,22:28,46,3,0,3,2022/11/05 10:28:00 PM
2022/11/05,22:26,45,3,6,9,2022/11/05 10:26:00 PM
2022/11/05,22:23,30,13,4,17,2022/11/05 10:23:00 PM
2022/11/05,22:29,11,1,0,1,2022/11/05 10:29:00 PM
2022/11/05,22:22,79,9,5,14,2022/11/05 10:22:00 PM
2022/11/05,22:30,3,11,16,27,2022/11/05 10:30:00 PM
2022/11/05,22:31,29,32,2,34,2022/11/05 10:31:00 PM
2022/11/05,22:22,37,3,21,24,2022/11/05 10:22:00 PM
2022/11/05,22:26,57,2,2,4,2022/11/05 10:26:00 PM
2022/11/05,22:31,9,1,0,1,2022/11/05 10:31:00 PM
2022/11/05,22:21,56,5,5,10,2022/11/05 10:21:00 PM
2022/11/05,22:26,63,12,4,16,2022/11/05 10:26:00 PM
2022/11/05,22:24,28,2,21,23,2022/11/05 10:24:00 PM
2022/11/05,22:21,70,2,0,2,2022/11/05 10:21:00 PM
2022/11/05,22:23,61,1,3,4,2022/11/05 10:23:00 PM
2022/11/05,22:23,14,4,2,6,2022/11/05 10:23:00 PM
2022/11/05,22:20,1,6,7,13,2022/11/05 10:20:00 PM
2022/11/05,22:31,8,5,0,5,2022/11/05 10:31:00 PM
2022/11/05,22:25,14,8,1,9,2022/11/05 10:25:00 PM
2022/11/05,22:21,28,7,14,21,2022/11/05 10:21:00 PM
2022/11/05,22:32,58,0,6,6,2022/11/05 10:32:00 PM
2022/11/05,22:32,68,2,3,5,2022/11/05 10:32:00 PM
2022/11/05,22:30,27,0,2,2,2022/11/05 10:30:00 PM
2022/11/05,22:20,41,16,10,26,2022/11/05 10:20:00 PM
2022/11/05,22:20,66,23,18,41,2022/11/05 10:20:00 PM
2022/11/05,22:19,51,0,4,4,2022/11/05 10:19:00 PM
2022/11/05,22:31,39,5,0,5,2022/11/05 10:31:00 PM
2022/11/05,22:33,77,2,0,2,2022/11/05 10:33:00 PM
2022/11/05,22:26,62,1,2,3,2022/11/05 10:26:00 PM
2022/11/05,22:24,18,0,1,1,2022/11/05 10:24:00 PM
2022/11/05,22:26,40,1,0,1,2022/11/05 10:26:00 PM
2022/11/05,22:21,29,19,2,21,2022/11/05 10:21:00 PM
2022/11/05,22:19,47,5,2,7,2022/11/05 10:19:00 PM
2022/11/05,22:22,49,2,0,2,2022/11/05 10:22:00 PM
2022/11/05,22:18,57,0,1,1,2022/11/05 10:18:00 PM
2022/11/05,22:21,4,3,3,6,2022/11/05 10:21:00 PM
2022/11/05,22:28,66,8,7,15,2022/11/05 10:28:00 PM
2022/11/05,22:29,23,0,4,4,2022/11/05 10:29:00 PM
2022/11/05,22:31,65,6,10,16,2022/11/05 10:31:00 PM
2022/11/05,22:22,87,0,4,4,2022/11/05 10:22:00 PM
2022/11/05,22:16,61,0,4,4,2022/11/05 10:16:00 PM
2022/11/05,22:25,62,0,7,7,2022/11/05 10:25:00 PM
2022/11/05,22:21,65,3,5,8,2022/11/05 10:21:00 PM
2022/11/05,22:10,23,0,2,2,2022/11/05 10:10:00 PM
2022/11/05,22:19,40,5,1,6,2022/11/05 10:19:00 PM
2022/11/05,22:23,5,3,16,19,2022/11/05 10:23:00 PM
2022/11/05,22:31,63,2,2,4,2022/11/05 10:31:00 PM
2022/11/05,22:26,5,9,10,19,2022/11/05 10:26:00 PM
2022/11/05,22:24,24,0,3,3,2022/11/05 10:24:00 PM
2022/11/05,22:36,65,1,21,22,2022/11/05 10:36:00 PM
2022/11/05,22:39,35,41,18,59,2022/11/05 10:39:00 PM
2022/11/05,22:34,47,5,3,8,2022/11/05 10:34:00 PM
2022/11/05,22:42,62,2,1,3,2022/11/05 10:42:00 PM
2022/11/05,22:33,45,5,3,8,2022/11/05 10:33:00 PM
2022/11/05,22:41,65,4,20,24,2022/11/05 10:41:00 PM
2022/11/05,22:35,67,1,0,1,2022/11/05 10:35:00 PM
2022/11/05,22:31,31,5,10,15,2022/11/05 10:31:00 PM
2022/11/05,22:36,49,2,1,3,2022/11/05 10:36:00 PM
2022/11/05,22:40,84,7,18,25,2022/11/05 10:40:00 PM
2022/11/05,22:32,48,1,3,4,2022/11/05 10:32:00 PM
2022/11/05,22:43,62,0,2,2,2022/11/05 10:43:00 PM
2022/11/05,22:47,58,0,1,1,2022/11/05 10:47:00 PM
2022/11/05,22:46,2,2,0,2,2022/11/05 10:46:00 PM
2022/11/05,22:36,45,5,3,8,2022/11/05 10:36:00 PM
2022/11/05,22:40,41,20,18,38,2022/11/05 10:40:00 PM
2022/11/05,22:39,5,10,8,18,2022/11/05 10:39:00 PM
2022/11/05,22:40,70,3,0,3,2022/11/05 10:40:00 PM
2022/11/05,22:45,21,21,1,22,2022/11/05 10:45:00 PM
2022/11/05,22:42,72,4,7,11,2022/11/05 10:42:00 PM
2022/11/05,22:37,86,1,0,1,2022/11/05 10:37:00 PM
2022/11/05,22:35,6,14,23,37,2022/11/05 10:35:00 PM
2022/11/05,22:26,19,2,18,20,2022/11/05 10:26:00 PM
2022/11/05,22:37,5,6,4,10,2022/11/05 10:37:00 PM
2022/11/05,22:48,50,5,1,6,2022/11/05 10:48:00 PM
2022/11/05,22:36,36,2,1,3,2022/11/05 10:36:00 PM
2022/11/05,22:38,59,10,4,14,2022/11/05 10:38:00 PM
2022/11/05,22:35,66,9,6,15,2022/11/05 10:35:00 PM
2022/11/05,22:40,30,9,6,15,2022/11/05 10:40:00 PM
2022/11/05,22:47,72,6,14,20,2022/11/05 10:47:00 PM
2022/11/05,22:39,21,12,17,29,2022/11/05 10:39:00 PM
2022/11/05,22:32,23,0,5,5,2022/11/05 10:32:00 PM
2022/11/05,22:42,20,5,4,9,2022/11/05 10:42:00 PM
2022/11/05,22:44,46,0,2,2,2022/11/05 10:44:00 PM
2022/11/05,22:35,1,4,3,7,2022/11/05 10:35:00 PM
2022/11/05,22:38,39,2,0,2,2022/11/05 10:38:00 PM
2022/11/05,22:42,40,6,0,6,2022/11/05 10:42:00 PM
2022/11/05,22:41,1,4,4,8,2022/11/05 10:41:00 PM
2022/11/05,22:40,6,14,5,19,2022/11/05 10:40:00 PM
2022/11/05,22:37,61,4,0,4,2022/11/05 10:37:00 PM
2022/11/05,22:41,10,0,9,9,2022/11/05 10:41:00 PM
2022/11/05,22:43,58,2,2,4,2022/11/05 10:43:00 PM
2022/11/05,22:34,62,0,3,3,2022/11/05 10:34:00 PM
2022/11/05,22:41,54,0,3,3,2022/11/05 10:41:00 PM
2022/11/05,22:45,8,0,1,1,2022/11/05 10:45:00 PM
2022/11/05,22:28,21,15,12,27,2022/11/05 10:28:00 PM
2022/11/05,22:35,39,1,2,3,2022/11/05 10:35:00 PM
2022/11/05,22:40,63,2,3,5,2022/11/05 10:40:00 PM
2022/11/05,22:41,9,3,0,3,2022/11/05 10:41:00 PM
2022/11/05,22:34,21,13,4,17,2022/11/05 10:34:00 PM
2022/11/05,22:38,30,3,8,11,2022/11/05 10:38:00 PM
2022/11/05,22:42,21,11,13,24,2022/11/05 10:42:00 PM
2022/11/05,22:41,66,2,3,5,2022/11/05 10:41:00 PM
2022/11/05,22:33,31,2,4,6,2022/11/05 10:33:00 PM
2022/11/05,22:45,50,2,2,4,2022/11/05 10:45:00 PM
2022/11/05,22:41,86,1,0,1,2022/11/05 10:41:00 PM
2022/11/05,22:41,14,8,3,11,2022/11/05 10:41:00 PM
2022/11/05,22:41,70,17,0,17,2022/11/05 10:41:00 PM
2022/11/05,22:37,66,9,11,20,2022/11/05 10:37:00 PM
2022/11/05,22:38,3,7,4,11,2022/11/05 10:38:00 PM
2022/11/05,22:48,9,1,0,1,2022/11/05 10:48:00 PM
2022/11/05,22:43,31,13,9,22,2022/11/05 10:43:00 PM
2022/11/05,22:46,56,3,0,3,2022/11/05 10:46:00 PM
2022/11/05,22:43,2,3,0,3,2022/11/05 10:43:00 PM
2022/11/05,22:35,4,20,9,29,2022/11/05 10:35:00 PM
2022/11/05,22:39,37,0,9,9,2022/11/05 10:39:00 PM
2022/11/05,22:35,14,8,0,8,2022/11/05 10:35:00 PM
2022/11/05,22:38,63,10,1,11,2022/11/05 10:38:00 PM
2022/11/05,22:45,77,1,0,1,2022/11/05 10:45:00 PM
2022/11/05,22:39,27,1,3,4,2022/11/05 10:39:00 PM
2022/11/05,22:40,28,1,96,97,2022/11/05 10:40:00 PM
2022/11/05,22:28,19,1,8,9,2022/11/05 10:28:00 PM
2022/11/05,22:33,50,8,10,18,2022/11/05 10:33:00 PM
2022/11/05,22:41,29,142,2,144,2022/11/05 10:41:00 PM
2022/11/05,22:31,5,8,1,9,2022/11/05 10:31:00 PM
2022/11/05,22:41,49,1,0,1,2022/11/05 10:41:00 PM
2022/11/05,22:46,86,5,0,5,2022/11/05 10:46:00 PM
2022/11/05,22:48,84,15,15,30,2022/11/05 10:48:00 PM
2022/11/05,22:46,84,16,8,24,2022/11/05 10:46:00 PM
2022/11/05,22:38,19,6,5,11,2022/11/05 10:38:00 PM
2022/11/05,22:34,12,6,6,12,2022/11/05 10:34:00 PM
2022/11/05,22:43,85,1,1,2,2022/11/05 10:43:00 PM
2022/11/05,22:41,48,0,5,5,2022/11/05 10:41:00 PM
2022/11/05,22:34,87,0,3,3,2022/11/05 10:34:00 PM
2022/11/05,22:43,40,16,0,16,2022/11/05 10:43:00 PM
2022/11/05,22:36,56,8,3,11,2022/11/05 10:36:00 PM
2022/11/05,22:38,77,0,1,1,2022/11/05 10:38:00 PM
2022/11/05,22:44,72,2,15,17,2022/11/05 10:44:00 PM
2022/11/05,22:41,35,26,11,37,2022/11/05 10:41:00 PM
2022/11/05,22:44,62,0,2,2,2022/11/05 10:44:00 PM
2022/11/05,22:38,6,19,3,22,2022/11/05 10:38:00 PM
2022/11/05,22:31,57,1,0,1,2022/11/05 10:31:00 PM
2022/11/05,22:36,62,2,7,9,2022/11/05 10:36:00 PM
2022/11/05,22:41,42,2,0,2,2022/11/05 10:41:00 PM
2022/11/05,22:40,61,1,2,3,2022/11/05 10:40:00 PM
2022/11/05,22:45,31,5,11,16,2022/11/05 10:45:00 PM
2022/11/05,22:45,72,3,11,14,2022/11/05 10:45:00 PM
2022/11/05,22:44,54,1,1,2,2022/11/05 10:44:00 PM
2022/11/05,22:49,72,4,3,7,2022/11/05 10:49:00 PM
2022/11/05,22:43,18,4,3,7,2022/11/05 10:43:00 PM
2022/11/05,22:40,12,4,0,4,2022/11/05 10:40:00 PM
2022/11/05,22:37,67,1,0,1,2022/11/05 10:37:00 PM
2022/11/05,22:39,31,6,7,13,2022/11/05 10:39:00 PM
2022/11/05,22:37,2,4,1,5,2022/11/05 10:37:00 PM
2022/11/05,22:40,11,2,0,2,2022/11/05 10:40:00 PM
2022/11/05,22:41,3,15,9,24,2022/11/05 10:41:00 PM
2022/11/05,22:36,30,10,8,18,2022/11/05 10:36:00 PM
2022/11/05,22:41,8,1,0,1,2022/11/05 10:41:00 PM
2022/11/05,22:44,79,9,5,14,2022/11/05 10:44:00 PM
2022/11/05,22:37,37,3,1,4,2022/11/05 10:37:00 PM
2022/11/05,22:29,37,2,6,8,2022/11/05 10:29:00 PM
2022/11/05,22:31,23,1,0,1,2022/11/05 10:31:00 PM
2022/11/05,22:42,30,4,4,8,2022/11/05 10:42:00 PM
2022/11/05,22:36,43,1,0,1,2022/11/05 10:36:00 PM
2022/11/05,22:44,56,5,1,6,2022/11/05 10:44:00 PM
2022/11/05,22:37,28,0,50,50,2022/11/05 10:37:00 PM
2022/11/05,22:39,59,11,3,14,2022/11/05 10:39:00 PM
2022/11/05,22:44,63,1,6,7,2022/11/05 10:44:00 PM
2022/11/05,22:48,3,20,17,37,2022/11/05 10:48:00 PM
2022/11/05,22:42,50,4,1,5,2022/11/05 10:42:00 PM
2022/11/05,22:49,59,8,1,9,2022/11/05 10:49:00 PM
2022/11/05,22:36,20,9,0,9,2022/11/05 10:36:00 PM
2022/11/05,22:43,5,6,11,17,2022/11/05 10:43:00 PM
2022/11/05,22:44,84,22,6,28,2022/11/05 10:44:00 PM
2022/11/05,22:47,29,162,9,171,2022/11/05 10:47:00 PM
2022/11/05,22:37,20,8,7,15,2022/11/05 10:37:00 PM
2022/11/05,22:47,49,0,1,1,2022/11/05 10:47:00 PM
2022/11/05,22:36,54,2,1,3,2022/11/05 10:36:00 PM
2022/11/05,22:33,40,5,0,5,2022/11/05 10:33:00 PM
2022/11/05,22:38,20,5,7,12,2022/11/05 10:38:00 PM
2022/11/05,22:46,70,4,3,7,2022/11/05 10:46:00 PM
2022/11/05,22:40,59,5,2,7,2022/11/05 10:40:00 PM
2022/11/05,22:44,50,7,0,7,2022/11/05 10:44:00 PM
2022/11/05,22:38,21,5,4,9,2022/11/05 10:38:00 PM
2022/11/05,22:38,23,5,4,9,2022/11/05 10:38:00 PM
2022/11/05,22:35,37,5,2,7,2022/11/05 10:35:00 PM
2022/11/05,22:40,20,3,2,5,2022/11/05 10:40:00 PM
2022/11/05,22:47,18,2,0,2,2022/11/05 10:47:00 PM
2022/11/05,22:34,4,16,6,22,2022/11/05 10:34:00 PM
2022/11/05,22:40,58,4,3,7,2022/11/05 10:40:00 PM
2022/11/05,22:37,58,0,5,5,2022/11/05 10:37:00 PM
2022/11/05,22:25,37,1,6,7,2022/11/05 10:25:00 PM
2022/11/05,22:36,28,1,21,22,2022/11/05 10:36:00 PM
2022/11/05,22:39,50,2,3,5,2022/11/05 10:39:00 PM
2022/11/05,22:41,4,14,3,17,2022/11/05 10:41:00 PM
2022/11/05,22:27,19,5,4,9,2022/11/05 10:27:00 PM
2022/11/05,22:44,67,5,3,8,2022/11/05 10:44:00 PM
2022/11/05,22:48,12,0,3,3,2022/11/05 10:48:00 PM
2022/11/05,22:43,50,2,0,2,2022/11/05 10:43:00 PM
2022/11/05,22:46,77,0,2,2,2022/11/05 10:46:00 PM
2022/11/05,22:42,41,17,26,43,2022/11/05 10:42:00 PM
2022/11/05,22:43,29,165,3,168,2022/11/05 10:43:00 PM
2022/11/05,22:34,65,8,15,23,2022/11/05 10:34:00 PM
2022/11/05,22:39,28,3,66,69,2022/11/05 10:39:00 PM
2022/11/05,22:41,46,2,0,2,2022/11/05 10:41:00 PM
2022/11/05,22:37,70,2,9,11,2022/11/05 10:37:00 PM
2022/11/05,22:45,41,7,14,21,2022/11/05 10:45:00 PM
2022/11/05,22:36,6,8,8,16,2022/11/05 10:36:00 PM
2022/11/05,22:32,40,3,1,4,2022/11/05 10:32:00 PM
2022/11/05,22:37,3,9,9,18,2022/11/05 10:37:00 PM
2022/11/05,22:46,1,3,1,4,2022/11/05 10:46:00 PM
2022/11/05,22:41,40,10,2,12,2022/11/05 10:41:00 PM
2022/11/05,22:30,21,7,7,14,2022/11/05 10:30:00 PM
2022/11/05,22:29,21,3,6,9,2022/11/05 10:29:00 PM
2022/11/05,22:36,29,24,13,37,2022/11/05 10:36:00 PM
2022/11/05,22:32,37,7,1,8,2022/11/05 10:32:00 PM
2022/11/05,22:48,67,4,1,5,2022/11/05 10:48:00 PM
2022/11/05,22:38,72,5,0,5,2022/11/05 10:38:00 PM
2022/11/05,22:35,31,8,5,13,2022/11/05 10:35:00 PM
2022/11/05,22:48,41,9,5,14,2022/11/05 10:48:00 PM
2022/11/05,22:38,29,96,3,99,2022/11/05 10:38:00 PM
2022/11/05,22:35,40,0,1,1,2022/11/05 10:35:00 PM
2022/11/05,22:38,31,3,5,8,2022/11/05 10:38:00 PM
2022/11/05,22:38,57,0,2,2,2022/11/05 10:38:00 PM
2022/11/05,22:46,58,2,8,10,2022/11/05 10:46:00 PM
2022/11/05,22:34,3,21,10,31,2022/11/05 10:34:00 PM
2022/11/05,22:44,51,0,2,2,2022/11/05 10:44:00 PM
2022/11/05,22:48,77,0,2,2,2022/11/05 10:48:00 PM
2022/11/05,22:35,12,0,2,2,2022/11/05 10:35:00 PM
2022/11/05,22:40,8,3,2,5,2022/11/05 10:40:00 PM
2022/11/05,22:38,40,24,1,25,2022/11/05 10:38:00 PM
2022/11/05,22:41,2,0,3,3,2022/11/05 10:41:00 PM
2022/11/05,22:47,42,0,1,1,2022/11/05 10:47:00 PM
2022/11/05,22:45,40,8,4,12,2022/11/05 10:45:00 PM
2022/11/05,22:40,35,26,14,40,2022/11/05 10:40:00 PM
2022/11/05,22:37,8,1,1,2,2022/11/05 10:37:00 PM
2022/11/05,22:29,31,7,5,12,2022/11/05 10:29:00 PM
2022/11/05,22:42,8,0,3,3,2022/11/05 10:42:00 PM
2022/11/05,22:37,45,11,9,20,2022/11/05 10:37:00 PM
2022/11/05,22:46,6,20,6,26,2022/11/05 10:46:00 PM
2022/11/05,22:45,45,15,12,27,2022/11/05 10:45:00 PM
2022/11/05,22:36,47,5,9,14,2022/11/05 10:36:00 PM
2022/11/05,22:40,19,9,9,18,2022/11/05 10:40:00 PM
2022/11/05,22:37,24,10,3,13,2022/11/05 10:37:00 PM
2022/11/05,22:43,63,7,6,13,2022/11/05 10:43:00 PM
2022/11/05,22:39,70,6,1,7,2022/11/05 10:39:00 PM
2022/11/05,22:43,84,5,14,19,2022/11/05 10:43:00 PM
2022/11/05,22:43,1,4,4,8,2022/11/05 10:43:00 PM
2022/11/05,22:31,44,0,1,1,2022/11/05 10:31:00 PM
2022/11/05,22:41,21,3,11,14,2022/11/05 10:41:00 PM
2022/11/05,22:38,36,6,24,30,2022/11/05 10:38:00 PM
2022/11/05,22:34,86,0,1,1,2022/11/05 10:34:00 PM
2022/11/05,22:48,79,8,5,13,2022/11/05 10:48:00 PM
2022/11/05,22:34,51,1,2,3,2022/11/05 10:34:00 PM
2022/11/05,22:48,68,1,1,2,2022/11/05 10:48:00 PM
2022/11/05,22:47,56,3,1,4,2022/11/05 10:47:00 PM
2022/11/05,22:37,63,7,10,17,2022/11/05 10:37:00 PM
2022/11/05,22:35,63,6,1,7,2022/11/05 10:35:00 PM
2022/11/05,22:44,66,22,1,23,2022/11/05 10:44:00 PM
2022/11/05,22:39,43,1,0,1,2022/11/05 10:39:00 PM
2022/11/05,22:36,19,10,19,29,2022/11/05 10:36:00 PM
2022/11/05,22:34,18,0,1,1,2022/11/05 10:34:00 PM
2022/11/05,22:44,5,7,9,16,2022/11/05 10:44:00 PM
2022/11/05,22:36,40,3,0,3,2022/11/05 10:36:00 PM
2022/11/05,22:48,54,2,4,6,2022/11/05 10:48:00 PM
2022/11/05,22:44,59,3,5,8,2022/11/05 10:44:00 PM
2022/11/05,22:45,11,1,0,1,2022/11/05 10:45:00 PM
2022/11/05,22:34,41,15,19,34,2022/11/05 10:34:00 PM
2022/11/05,22:48,66,3,2,5,2022/11/05 10:48:00 PM
2022/11/05,22:48,28,5,72,77,2022/11/05 10:48:00 PM
2022/11/05,22:39,4,21,6,27,2022/11/05 10:39:00 PM
2022/11/05,22:41,84,5,16,21,2022/11/05 10:41:00 PM
2022/11/05,22:39,14,12,2,14,2022/11/05 10:39:00 PM
2022/11/05,22:46,68,1,1,2,2022/11/05 10:46:00 PM
2022/11/05,22:31,20,19,5,24,2022/11/05 10:31:00 PM
2022/11/05,22:41,87,0,3,3,2022/11/05 10:41:00 PM
2022/11/05,22:41,63,7,2,9,2022/11/05 10:41:00 PM
2022/11/05,22:40,49,1,0,1,2022/11/05 10:40:00 PM
2022/11/05,22:38,48,2,2,4,2022/11/05 10:38:00 PM
2022/11/05,22:46,12,4,3,7,2022/11/05 10:46:00 PM
2022/11/05,22:34,20,7,13,20,2022/11/05 10:34:00 PM
2022/11/05,22:43,86,4,0,4,2022/11/05 10:43:00 PM
2022/11/05,22:36,63,2,4,6,2022/11/05 10:36:00 PM
2022/11/05,22:36,67,2,4,6,2022/11/05 10:36:00 PM
2022/11/05,22:44,58,7,8,15,2022/11/05 10:44:00 PM
2022/11/05,22:36,1,17,1,18,2022/11/05 10:36:00 PM
2022/11/05,22:39,36,4,2,6,2022/11/05 10:39:00 PM
2022/11/05,22:43,68,1,1,2,2022/11/05 10:43:00 PM
2022/11/05,22:40,31,9,6,15,2022/11/05 10:40:00 PM
2022/11/05,22:45,51,1,1,2,2022/11/05 10:45:00 PM
2022/11/05,22:49,70,3,0,3,2022/11/05 10:49:00 PM
2022/11/05,22:39,20,17,0,17,2022/11/05 10:39:00 PM
2022/11/05,22:34,23,5,1,6,2022/11/05 10:34:00 PM
2022/11/05,22:35,50,1,0,1,2022/11/05 10:35:00 PM
2022/11/05,22:48,35,50,20,70,2022/11/05 10:48:00 PM
2022/11/05,22:39,6,17,2,19,2022/11/05 10:39:00 PM
2022/11/05,22:35,58,3,3,6,2022/11/05 10:35:00 PM
2022/11/05,22:34,61,1,5,6,2022/11/05 10:34:00 PM
2022/11/05,22:43,59,1,3,4,2022/11/05 10:43:00 PM
2022/11/05,22:44,31,7,7,14,2022/11/05 10:44:00 PM
2022/11/05,22:47,9,0,4,4,2022/11/05 10:47:00 PM
2022/11/05,22:28,37,0,9,9,2022/11/05 10:28:00 PM
2022/11/05,22:49,14,3,2,5,2022/11/05 10:49:00 PM
2022/11/05,22:44,12,5,1,6,2022/11/05 10:44:00 PM
2022/11/05,22:36,5,12,14,26,2022/11/05 10:36:00 PM
2022/11/05,22:41,30,7,8,15,2022/11/05 10:41:00 PM
2022/11/05,22:34,63,6,6,12,2022/11/05 10:34:00 PM
2022/11/05,22:47,3,13,13,26,2022/11/05 10:47:00 PM
2022/11/05,22:37,14,15,3,18,2022/11/05 10:37:00 PM
2022/11/05,22:42,58,11,2,13,2022/11/05 10:42:00 PM
2022/11/05,22:41,37,0,8,8,2022/11/05 10:41:00 PM
2022/11/05,22:48,4,28,9,37,2022/11/05 10:48:00 PM
2022/11/05,22:34,19,24,1,25,2022/11/05 10:34:00 PM
2022/11/05,22:46,11,0,2,2,2022/11/05 10:46:00 PM
2022/11/05,22:37,42,0,1,1,2022/11/05 10:37:00 PM
2022/11/05,22:46,28,5,75,80,2022/11/05 10:46:00 PM
2022/11/05,22:37,39,3,2,5,2022/11/05 10:37:00 PM
2022/11/05,22:42,87,4,0,4,2022/11/05 10:42:00 PM
2022/11/05,22:40,1,8,5,13,2022/11/05 10:40:00 PM
2022/11/05,22:46,72,2,11,13,2022/11/05 10:46:00 PM
2022/11/05,22:43,49,2,1,3,2022/11/05 10:43:00 PM
2022/11/05,22:49,79,34,7,41,2022/11/05 10:49:00 PM
2022/11/05,22:44,48,3,4,7,2022/11/05 10:44:00 PM
2022/11/05,22:46,50,1,1,2,2022/11/05 10:46:00 PM
2022/11/05,22:36,2,3,3,6,2022/11/05 10:36:00 PM
2022/11/05,22:45,27,2,0,2,2022/11/05 10:45:00 PM
2022/11/05,22:34,58,3,1,4,2022/11/05 10:34:00 PM
2022/11/05,22:25,31,7,7,14,2022/11/05 10:25:00 PM
2022/11/05,22:42,63,2,3,5,2022/11/05 10:42:00 PM
2022/11/05,22:37,84,7,11,18,2022/11/05 10:37:00 PM
2022/11/05,22:32,30,24,13,37,2022/11/05 10:32:00 PM
2022/11/05,22:37,59,1,1,2,2022/11/05 10:37:00 PM
2022/11/05,22:36,10,1,0,1,2022/11/05 10:36:00 PM
2022/11/05,22:40,65,8,9,17,2022/11/05 10:40:00 PM
2022/11/05,22:45,12,7,2,9,2022/11/05 10:45:00 PM
2022/11/05,22:46,59,11,2,13,2022/11/05 10:46:00 PM
2022/11/05,22:32,21,3,10,13,2022/11/05 10:32:00 PM
2022/11/05,22:46,21,3,10,13,2022/11/05 10:46:00 PM
2022/11/05,22:26,31,12,6,18,2022/11/05 10:26:00 PM
2022/11/05,22:30,19,4,2,6,2022/11/05 10:30:00 PM
2022/11/05,22:39,62,1,0,1,2022/11/05 10:39:00 PM
2022/11/05,22:45,54,1,0,1,2022/11/05 10:45:00 PM
2022/11/05,22:33,30,15,8,23,2022/11/05 10:33:00 PM
2022/11/05,22:48,1,4,2,6,2022/11/05 10:48:00 PM
2022/11/05,22:37,48,0,1,1,2022/11/05 10:37:00 PM
2022/11/05,22:42,1,5,4,9,2022/11/05 10:42:00 PM
2022/11/05,22:39,41,18,22,40,2022/11/05 10:39:00 PM
2022/11/05,22:42,29,164,7,171,2022/11/05 10:42:00 PM
2022/11/05,22:28,31,6,11,17,2022/11/05 10:28:00 PM
2022/11/05,22:42,67,0,4,4,2022/11/05 10:42:00 PM
2022/11/05,22:46,47,2,10,12,2022/11/05 10:46:00 PM
2022/11/05,22:34,45,3,13,16,2022/11/05 10:34:00 PM
2022/11/05,22:33,20,16,1,17,2022/11/05 10:33:00 PM
2022/11/05,22:44,49,1,0,1,2022/11/05 10:44:00 PM
2022/11/05,22:47,87,0,2,2,2022/11/05 10:47:00 PM
2022/11/05,22:40,14,6,1,7,2022/11/05 10:40:00 PM
2022/11/05,22:35,36,6,6,12,2022/11/05 10:35:00 PM
2022/11/05,22:47,12,1,3,4,2022/11/05 10:47:00 PM
2022/11/05,22:47,54,3,0,3,2022/11/05 10:47:00 PM
2022/11/05,22:40,54,1,1,2,2022/11/05 10:40:00 PM
2022/11/05,22:34,30,15,7,22,2022/11/05 10:34:00 PM
2022/11/05,22:37,36,1,2,3,2022/11/05 10:37:00 PM
2022/11/05,22:40,77,2,4,6,2022/11/05 10:40:00 PM
2022/11/05,22:34,37,5,1,6,2022/11/05 10:34:00 PM
2022/11/05,22:32,46,4,3,7,2022/11/05 10:32:00 PM
2022/11/05,22:36,23,1,4,5,2022/11/05 10:36:00 PM
2022/11/05,22:46,49,0,2,2,2022/11/05 10:46:00 PM
2022/11/05,22:48,14,5,0,5,2022/11/05 10:48:00 PM
2022/11/05,22:30,40,5,0,5,2022/11/05 10:30:00 PM
2022/11/05,22:38,49,1,0,1,2022/11/05 10:38:00 PM
2022/11/05,22:45,65,1,35,36,2022/11/05 10:45:00 PM
2022/11/05,22:40,48,0,1,1,2022/11/05 10:40:00 PM
2022/11/05,22:47,41,23,19,42,2022/11/05 10:47:00 PM
2022/11/05,22:43,24,4,4,8,2022/11/05 10:43:00 PM
2022/11/05,22:42,14,9,2,11,2022/11/05 10:42:00 PM
2022/11/05,22:32,20,7,6,13,2022/11/05 10:32:00 PM
2022/11/05,22:35,62,4,0,4,2022/11/05 10:35:00 PM
2022/11/05,22:38,65,3,16,19,2022/11/05 10:38:00 PM
2022/11/05,22:30,5,10,6,16,2022/11/05 10:30:00 PM
2022/11/05,22:40,69,2,1,3,2022/11/05 10:40:00 PM
2022/11/05,22:47,67,18,3,21,2022/11/05 10:47:00 PM
2022/11/05,22:35,48,4,5,9,2022/11/05 10:35:00 PM
2022/11/05,22:37,44,2,0,2,2022/11/05 10:37:00 PM
2022/11/05,22:36,12,0,3,3,2022/11/05 10:36:00 PM
2022/11/05,22:49,62,0,1,1,2022/11/05 10:49:00 PM
2022/11/05,22:48,24,0,1,1,2022/11/05 10:48:00 PM
2022/11/05,22:36,14,3,3,6,2022/11/05 10:36:00 PM
2022/11/05,22:34,69,2,1,3,2022/11/05 10:34:00 PM
2022/11/05,22:29,19,3,4,7,2022/11/05 10:29:00 PM
2022/11/05,22:38,2,0,4,4,2022/11/05 10:38:00 PM
2022/11/05,22:38,41,17,17,34,2022/11/05 10:38:00 PM
2022/11/05,22:41,62,0,3,3,2022/11/05 10:41:00 PM
2022/11/05,22:36,66,11,10,21,2022/11/05 10:36:00 PM
2022/11/05,22:46,3,13,14,27,2022/11/05 10:46:00 PM
2022/11/05,22:39,24,3,3,6,2022/11/05 10:39:00 PM
2022/11/05,22:45,28,0,99,99,2022/11/05 10:45:00 PM
2022/11/05,22:39,9,2,0,2,2022/11/05 10:39:00 PM
2022/11/05,22:42,3,38,9,47,2022/11/05 10:42:00 PM
2022/11/05,22:34,48,1,0,1,2022/11/05 10:34:00 PM
2022/11/05,22:34,27,1,1,2,2022/11/05 10:34:00 PM
2022/11/05,22:34,10,0,1,1,2022/11/05 10:34:00 PM
2022/11/05,22:36,39,2,0,2,2022/11/05 10:36:00 PM
2022/11/05,22:39,57,2,0,2,2022/11/05 10:39:00 PM
2022/11/05,22:42,9,2,0,2,2022/11/05 10:42:00 PM
2022/11/05,22:46,24,1,6,7,2022/11/05 10:46:00 PM
2022/11/05,22:37,62,1,5,6,2022/11/05 10:37:00 PM
2022/11/05,22:26,21,9,8,17,2022/11/05 10:26:00 PM
2022/11/05,22:48,11,1,1,2,2022/11/05 10:48:00 PM
2022/11/05,22:40,66,10,6,16,2022/11/05 10:40:00 PM
2022/11/05,22:39,30,4,13,17,2022/11/05 10:39:00 PM
2022/11/05,22:36,41,15,15,30,2022/11/05 10:36:00 PM
2022/11/05,22:45,56,2,0,2,2022/11/05 10:45:00 PM
2022/11/05,22:34,35,37,9,46,2022/11/05 10:34:00 PM
2022/11/05,22:41,6,19,19,38,2022/11/05 10:41:00 PM
2022/11/05,22:36,50,4,0,4,2022/11/05 10:36:00 PM
2022/11/05,22:35,46,3,1,4,2022/11/05 10:35:00 PM
2022/11/05,22:42,45,5,6,11,2022/11/05 10:42:00 PM
2022/11/05,22:35,35,45,13,58,2022/11/05 10:35:00 PM
2022/11/05,22:43,12,2,5,7,2022/11/05 10:43:00 PM
2022/11/05,22:47,70,4,2,6,2022/11/05 10:47:00 PM
2022/11/05,22:47,47,0,2,2,2022/11/05 10:47:00 PM
2022/11/05,22:44,24,2,6,8,2022/11/05 10:44:00 PM
2022/11/05,22:44,14,1,0,1,2022/11/05 10:44:00 PM
2022/11/05,22:46,69,1,0,1,2022/11/05 10:46:00 PM
2022/11/05,22:39,63,15,7,22,2022/11/05 10:39:00 PM
2022/11/05,22:41,24,2,1,3,2022/11/05 10:41:00 PM
2022/11/05,22:35,65,6,9,15,2022/11/05 10:35:00 PM
2022/11/05,22:45,86,1,0,1,2022/11/05 10:45:00 PM
2022/11/05,22:42,6,8,9,17,2022/11/05 10:42:00 PM
2022/11/05,22:40,5,10,12,22,2022/11/05 10:40:00 PM
2022/11/05,22:43,42,0,3,3,2022/11/05 10:43:00 PM
2022/11/05,22:47,66,9,14,23,2022/11/05 10:47:00 PM
2022/11/05,22:40,36,7,0,7,2022/11/05 10:40:00 PM
2022/11/05,22:43,48,0,2,2,2022/11/05 10:43:00 PM
2022/11/05,22:45,18,5,1,6,2022/11/05 10:45:00 PM
2022/11/05,22:27,31,6,8,14,2022/11/05 10:27:00 PM
2022/11/05,22:32,61,4,1,5,2022/11/05 10:32:00 PM
2022/11/05,22:38,62,1,0,1,2022/11/05 10:38:00 PM
2022/11/05,22:30,31,4,2,6,2022/11/05 10:30:00 PM
2022/11/05,22:37,72,5,0,5,2022/11/05 10:37:00 PM
2022/11/05,22:31,40,4,2,6,2022/11/05 10:31:00 PM
2022/11/05,22:36,35,41,11,52,2022/11/05 10:36:00 PM
2022/11/05,22:38,27,4,0,4,2022/11/05 10:38:00 PM
2022/11/05,22:43,70,16,0,16,2022/11/05 10:43:00 PM
2022/11/05,22:31,37,3,1,4,2022/11/05 10:31:00 PM
2022/11/05,22:45,46,1,0,1,2022/11/05 10:45:00 PM
2022/11/05,22:47,27,1,3,4,2022/11/05 10:47:00 PM
2022/11/05,22:35,70,0,2,2,2022/11/05 10:35:00 PM
2022/11/05,22:43,67,7,0,7,2022/11/05 10:43:00 PM
2022/11/05,22:44,77,5,4,9,2022/11/05 10:44:00 PM
2022/11/05,22:36,4,13,10,23,2022/11/05 10:36:00 PM
2022/11/05,22:40,45,10,11,21,2022/11/05 10:40:00 PM
2022/11/05,22:42,12,0,10,10,2022/11/05 10:42:00 PM
2022/11/05,22:42,51,1,1,2,2022/11/05 10:42:00 PM
2022/11/05,22:36,27,2,1,3,2022/11/05 10:36:00 PM
2022/11/05,22:35,20,3,5,8,2022/11/05 10:35:00 PM
2022/11/05,22:44,6,16,7,23,2022/11/05 10:44:00 PM
2022/11/05,22:36,48,0,1,1,2022/11/05 10:36:00 PM
2022/11/05,22:39,29,93,5,98,2022/11/05 10:39:00 PM
2022/11/05,22:40,27,5,1,6,2022/11/05 10:40:00 PM
2022/11/05,22:45,29,180,3,183,2022/11/05 10:45:00 PM
2022/11/05,22:47,1,1,7,8,2022/11/05 10:47:00 PM
2022/11/05,22:47,65,5,18,23,2022/11/05 10:47:00 PM
2022/11/05,22:35,41,18,15,33,2022/11/05 10:35:00 PM
2022/11/05,22:31,30,28,9,37,2022/11/05 10:31:00 PM
2022/11/05,22:33,49,0,2,2,2022/11/05 10:33:00 PM
2022/11/05,22:39,1,3,12,15,2022/11/05 10:39:00 PM
2022/11/05,22:39,72,0,11,11,2022/11/05 10:39:00 PM
2022/11/05,22:41,45,6,5,11,2022/11/05 10:41:00 PM
2022/11/05,22:45,4,21,6,27,2022/11/05 10:45:00 PM
2022/11/05,22:34,46,2,0,2,2022/11/05 10:34:00 PM
2022/11/05,22:43,37,2,0,2,2022/11/05 10:43:00 PM
2022/11/05,22:42,61,4,4,8,2022/11/05 10:42:00 PM
2022/11/05,22:35,27,2,1,3,2022/11/05 10:35:00 PM
2022/11/05,22:41,19,5,11,16,2022/11/05 10:41:00 PM
2022/11/05,22:44,2,2,2,4,2022/11/05 10:44:00 PM
2022/11/05,22:35,29,25,1,26,2022/11/05 10:35:00 PM
2022/11/05,22:31,61,3,2,5,2022/11/05 10:31:00 PM
2022/11/05,22:34,68,0,4,4,2022/11/05 10:34:00 PM
2022/11/05,22:36,8,0,1,1,2022/11/05 10:36:00 PM
2022/11/05,22:48,72,7,25,32,2022/11/05 10:48:00 PM
2022/11/05,22:39,58,1,3,4,2022/11/05 10:39:00 PM
2022/11/05,22:41,57,0,1,1,2022/11/05 10:41:00 PM
2022/11/05,22:35,56,1,3,4,2022/11/05 10:35:00 PM
2022/11/05,22:32,36,14,2,16,2022/11/05 10:32:00 PM
2022/11/05,22:44,68,0,1,1,2022/11/05 10:44:00 PM
2022/11/05,22:40,4,19,3,22,2022/11/05 10:40:00 PM
2022/11/05,22:46,10,1,3,4,2022/11/05 10:46:00 PM
2022/11/05,22:33,46,1,3,4,2022/11/05 10:33:00 PM
2022/11/05,22:39,87,0,1,1,2022/11/05 10:39:00 PM
2022/11/05,22:39,54,5,0,5,2022/11/05 10:39:00 PM
2022/11/05,22:38,24,1,13,14,2022/11/05 10:38:00 PM
2022/11/05,22:38,18,0,3,3,2022/11/05 10:38:00 PM
2022/11/05,22:35,3,7,9,16,2022/11/05 10:35:00 PM
2022/11/05,22:39,3,18,2,20,2022/11/05 10:39:00 PM
2022/11/05,22:36,21,8,12,20,2022/11/05 10:36:00 PM
2022/11/05,22:47,11,1,0,1,2022/11/05 10:47:00 PM
2022/11/05,22:27,37,8,0,8,2022/11/05 10:27:00 PM
2022/11/05,22:39,51,0,2,2,2022/11/05 10:39:00 PM
2022/11/05,22:35,30,19,9,28,2022/11/05 10:35:00 PM
2022/11/05,22:38,5,15,9,24,2022/11/05 10:38:00 PM
2022/11/05,22:39,47,13,8,21,2022/11/05 10:39:00 PM
2022/11/05,22:34,56,3,0,3,2022/11/05 10:34:00 PM
2022/11/05,22:35,19,10,17,27,2022/11/05 10:35:00 PM
2022/11/05,22:40,3,24,7,31,2022/11/05 10:40:00 PM
2022/11/05,22:30,61,2,0,2,2022/11/05 10:30:00 PM
2022/11/05,22:39,67,6,0,6,2022/11/05 10:39:00 PM
2022/11/05,22:37,41,16,11,27,2022/11/05 10:37:00 PM
2022/11/05,22:37,65,0,23,23,2022/11/05 10:37:00 PM
2022/11/05,22:48,6,7,8,15,2022/11/05 10:48:00 PM
2022/11/05,22:36,3,26,24,50,2022/11/05 10:36:00 PM
2022/11/05,22:35,51,2,2,4,2022/11/05 10:35:00 PM
2022/11/05,22:44,4,20,7,27,2022/11/05 10:44:00 PM
2022/11/05,22:38,45,13,12,25,2022/11/05 10:38:00 PM
2022/11/05,22:37,23,1,4,5,2022/11/05 10:37:00 PM
2022/11/05,22:38,50,1,2,3,2022/11/05 10:38:00 PM
2022/11/05,22:39,84,3,15,18,2022/11/05 10:39:00 PM
2022/11/05,22:35,61,3,0,3,2022/11/05 10:35:00 PM
2022/11/05,22:47,59,7,5,12,2022/11/05 10:47:00 PM
2022/11/05,22:44,37,2,6,8,2022/11/05 10:44:00 PM
2022/11/05,22:34,31,8,3,11,2022/11/05 10:34:00 PM
2022/11/05,22:44,65,2,43,45,2022/11/05 10:44:00 PM
2022/11/05,22:45,58,0,7,7,2022/11/05 10:45:00 PM
2022/11/05,22:44,42,0,2,2,2022/11/05 10:44:00 PM
2022/11/05,22:36,37,0,1,1,2022/11/05 10:36:00 PM
2022/11/05,22:44,19,6,10,16,2022/11/05 10:44:00 PM
2022/11/05,22:37,50,3,0,3,2022/11/05 10:37:00 PM
2022/11/05,22:39,61,5,1,6,2022/11/05 10:39:00 PM
2022/11/05,22:46,41,33,22,55,2022/11/05 10:46:00 PM
2022/11/05,22:40,56,2,1,3,2022/11/05 10:40:00 PM
2022/11/05,22:48,2,4,1,5,2022/11/05 10:48:00 PM
2022/11/05,22:39,40,18,0,18,2022/11/05 10:39:00 PM
2022/11/05,22:38,42,4,2,6,2022/11/05 10:38:00 PM
2022/11/05,22:43,8,0,2,2,2022/11/05 10:43:00 PM
2022/11/05,22:43,35,50,18,68,2022/11/05 10:43:00 PM
2022/11/05,22:41,31,9,8,17,2022/11/05 10:41:00 PM
2022/11/05,22:45,24,1,3,4,2022/11/05 10:45:00 PM
2022/11/05,22:35,47,5,4,9,2022/11/05 10:35:00 PM
2022/11/05,22:43,3,23,10,33,2022/11/05 10:43:00 PM
2022/11/05,22:42,66,14,5,19,2022/11/05 10:42:00 PM
2022/11/05,22:42,31,10,6,16,2022/11/05 10:42:00 PM
2022/11/05,22:45,68,0,1,1,2022/11/05 10:45:00 PM
2022/11/05,22:32,57,2,0,2,2022/11/05 10:32:00 PM
2022/11/05,22:35,42,2,1,3,2022/11/05 10:35:00 PM
2022/11/05,22:41,61,3,1,4,2022/11/05 10:41:00 PM
2022/11/05,22:37,1,8,4,12,2022/11/05 10:37:00 PM
2022/11/05,22:34,57,0,1,1,2022/11/05 10:34:00 PM
2022/11/05,22:46,14,3,0,3,2022/11/05 10:46:00 PM
2022/11/05,22:49,66,14,12,26,2022/11/05 10:49:00 PM
2022/11/05,22:37,54,1,3,4,2022/11/05 10:37:00 PM
2022/11/05,22:38,35,30,28,58,2022/11/05 10:38:00 PM
2022/11/05,22:44,30,16,5,21,2022/11/05 10:44:00 PM
2022/11/05,22:47,24,3,5,8,2022/11/05 10:47:00 PM
2022/11/05,22:42,35,28,8,36,2022/11/05 10:42:00 PM
2022/11/05,22:34,54,1,1,2,2022/11/05 10:34:00 PM
2022/11/05,22:42,47,3,16,19,2022/11/05 10:42:00 PM
2022/11/05,22:42,68,0,4,4,2022/11/05 10:42:00 PM
2022/11/05,22:44,29,174,2,176,2022/11/05 10:44:00 PM
2022/11/05,22:26,37,0,19,19,2022/11/05 10:26:00 PM
2022/11/05,22:33,5,7,11,18,2022/11/05 10:33:00 PM
2022/11/05,22:42,59,3,2,5,2022/11/05 10:42:00 PM
2022/11/05,22:43,21,13,3,16,2022/11/05 10:43:00 PM
2022/11/05,22:44,87,0,3,3,2022/11/05 10:44:00 PM
2022/11/05,22:42,24,2,1,3,2022/11/05 10:42:00 PM
2022/11/05,22:40,42,1,0,1,2022/11/05 10:40:00 PM
2022/11/05,22:41,28,1,85,86,2022/11/05 10:41:00 PM
2022/11/05,22:45,79,7,3,10,2022/11/05 10:45:00 PM
2022/11/05,22:43,72,4,14,18,2022/11/05 10:43:00 PM
2022/11/05,22:38,46,1,0,1,2022/11/05 10:38:00 PM
2022/11/05,22:45,1,3,11,14,2022/11/05 10:45:00 PM
2022/11/05,22:46,19,5,9,14,2022/11/05 10:46:00 PM
2022/11/05,22:38,61,1,1,2,2022/11/05 10:38:00 PM
2022/11/05,22:35,59,5,5,10,2022/11/05 10:35:00 PM
2022/11/05,22:43,39,1,0,1,2022/11/05 10:43:00 PM
2022/11/05,22:33,36,0,2,2,2022/11/05 10:33:00 PM
2022/11/05,22:44,10,0,1,1,2022/11/05 10:44:00 PM
2022/11/05,22:43,47,17,5,22,2022/11/05 10:43:00 PM
2022/11/05,22:37,11,0,1,1,2022/11/05 10:37:00 PM
2022/11/05,22:36,68,0,5,5,2022/11/05 10:36:00 PM
2022/11/05,22:36,58,1,4,5,2022/11/05 10:36:00 PM
2022/11/05,22:43,77,3,0,3,2022/11/05 10:43:00 PM
2022/11/05,22:47,84,7,9,16,2022/11/05 10:47:00 PM
2022/11/05,22:42,79,17,2,19,2022/11/05 10:42:00 PM
2022/11/05,22:36,24,6,2,8,2022/11/05 10:36:00 PM
2022/11/05,22:46,30,8,6,14,2022/11/05 10:46:00 PM
2022/11/05,22:30,23,0,2,2,2022/11/05 10:30:00 PM
2022/11/05,22:48,56,2,1,3,2022/11/05 10:48:00 PM
2022/11/05,22:45,59,6,0,6,2022/11/05 10:45:00 PM
2022/11/05,22:46,67,2,2,4,2022/11/05 10:46:00 PM
2022/11/05,22:36,61,1,3,4,2022/11/05 10:36:00 PM
2022/11/05,22:45,66,14,5,19,2022/11/05 10:45:00 PM
2022/11/05,22:43,69,1,1,2,2022/11/05 10:43:00 PM
2022/11/05,22:43,61,3,0,3,2022/11/05 10:43:00 PM
2022/11/05,22:41,12,0,3,3,2022/11/05 10:41:00 PM
2022/11/05,22:48,49,0,2,2,2022/11/05 10:48:00 PM
2022/11/05,22:47,30,10,4,14,2022/11/05 10:47:00 PM
2022/11/05,22:46,39,0,4,4,2022/11/05 10:46:00 PM
2022/11/05,22:36,51,2,2,4,2022/11/05 10:36:00 PM
2022/11/05,22:41,41,14,19,33,2022/11/05 10:41:00 PM
2022/11/05,22:48,29,110,2,112,2022/11/05 10:48:00 PM
2022/11/05,22:47,45,5,14,19,2022/11/05 10:47:00 PM
2022/11/05,22:45,67,6,1,7,2022/11/05 10:45:00 PM
2022/11/05,22:47,62,3,1,4,2022/11/05 10:47:00 PM
2022/11/05,22:45,19,7,7,14,2022/11/05 10:45:00 PM
2022/11/05,22:38,84,10,8,18,2022/11/05 10:38:00 PM
2022/11/05,22:45,14,12,1,13,2022/11/05 10:45:00 PM
2022/11/05,22:47,63,6,3,9,2022/11/05 10:47:00 PM
2022/11/05,22:47,86,4,0,4,2022/11/05 10:47:00 PM
2022/11/05,22:44,28,1,101,102,2022/11/05 10:44:00 PM
2022/11/05,22:35,11,1,1,2,2022/11/05 10:35:00 PM
2022/11/05,22:43,45,8,5,13,2022/11/05 10:43:00 PM
2022/11/05,22:33,48,1,0,1,2022/11/05 10:33:00 PM
2022/11/05,22:37,49,4,1,5,2022/11/05 10:37:00 PM
2022/11/05,22:40,51,3,7,10,2022/11/05 10:40:00 PM
2022/11/05,22:42,11,1,0,1,2022/11/05 10:42:00 PM
2022/11/05,22:46,29,160,0,160,2022/11/05 10:46:00 PM
2022/11/05,22:33,44,0,1,1,2022/11/05 10:33:00 PM
2022/11/05,22:34,67,9,1,10,2022/11/05 10:34:00 PM
2022/11/05,22:45,84,13,10,23,2022/11/05 10:45:00 PM
2022/11/05,22:37,29,58,6,64,2022/11/05 10:37:00 PM
2022/11/05,22:43,28,0,106,106,2022/11/05 10:43:00 PM
2022/11/05,22:40,37,0,9,9,2022/11/05 10:40:00 PM
2022/11/05,22:35,79,7,5,12,2022/11/05 10:35:00 PM
2022/11/05,22:42,84,14,4,18,2022/11/05 10:42:00 PM
2022/11/05,22:45,35,47,15,62,2022/11/05 10:45:00 PM
2022/11/05,22:42,36,4,0,4,2022/11/05 10:42:00 PM
2022/11/05,22:37,6,6,17,23,2022/11/05 10:37:00 PM
2022/11/05,22:47,6,22,19,41,2022/11/05 10:47:00 PM
2022/11/05,22:43,19,4,10,14,2022/11/05 10:43:00 PM
2022/11/05,22:46,4,28,4,32,2022/11/05 10:46:00 PM
2022/11/05,22:44,47,10,2,12,2022/11/05 10:44:00 PM
2022/11/05,22:42,5,7,12,19,2022/11/05 10:42:00 PM
2022/11/05,22:40,21,6,9,15,2022/11/05 10:40:00 PM
2022/11/05,22:49,87,3,0,3,2022/11/05 10:49:00 PM
2022/11/05,22:38,51,2,0,2,2022/11/05 10:38:00 PM
2022/11/05,22:36,72,1,5,6,2022/11/05 10:36:00 PM
2022/11/05,22:37,68,0,1,1,2022/11/05 10:37:00 PM
2022/11/05,22:49,35,68,21,89,2022/11/05 10:49:00 PM
2022/11/05,22:43,20,6,0,6,2022/11/05 10:43:00 PM
2022/11/05,22:33,23,1,4,5,2022/11/05 10:33:00 PM
2022/11/05,22:38,66,6,12,18,2022/11/05 10:38:00 PM
2022/11/05,22:39,48,1,4,5,2022/11/05 10:39:00 PM
2022/11/05,22:40,50,17,0,17,2022/11/05 10:40:00 PM
2022/11/05,22:40,24,9,2,11,2022/11/05 10:40:00 PM
2022/11/05,22:35,5,5,9,14,2022/11/05 10:35:00 PM
2022/11/05,22:46,27,2,2,4,2022/11/05 10:46:00 PM
2022/11/05,22:46,45,32,7,39,2022/11/05 10:46:00 PM
2022/11/05,22:37,47,4,1,5,2022/11/05 10:37:00 PM
2022/11/05,22:46,35,24,11,35,2022/11/05 10:46:00 PM
2022/11/05,22:41,79,3,10,13,2022/11/05 10:41:00 PM
2022/11/05,22:35,54,0,2,2,2022/11/05 10:35:00 PM
2022/11/05,22:37,12,2,6,8,2022/11/05 10:37:00 PM
2022/11/05,22:43,66,18,6,24,2022/11/05 10:43:00 PM
2022/11/05,22:41,5,12,12,24,2022/11/05 10:41:00 PM
2022/11/05,22:34,1,3,1,4,2022/11/05 10:34:00 PM
2022/11/05,22:40,86,0,1,1,2022/11/05 10:40:00 PM
2022/11/05,22:42,77,0,5,5,2022/11/05 10:42:00 PM
2022/11/05,22:37,4,15,14,29,2022/11/05 10:37:00 PM
2022/11/05,22:42,48,2,0,2,2022/11/05 10:42:00 PM
2022/11/05,22:37,31,0,6,6,2022/11/05 10:37:00 PM
2022/11/05,22:37,21,2,9,11,2022/11/05 10:37:00 PM
2022/11/05,22:46,63,9,1,10,2022/11/05 10:46:00 PM
2022/11/05,22:38,70,3,0,3,2022/11/05 10:38:00 PM
2022/11/05,22:48,70,2,2,4,2022/11/05 10:48:00 PM
2022/11/05,22:45,37,2,6,8,2022/11/05 10:45:00 PM
2022/11/05,22:43,56,2,3,5,2022/11/05 10:43:00 PM
2022/11/05,22:32,5,12,8,20,2022/11/05 10:32:00 PM
2022/11/05,22:40,62,3,9,12,2022/11/05 10:40:00 PM
2022/11/05,22:45,3,13,1,14,2022/11/05 10:45:00 PM
2022/11/05,22:41,59,1,1,2,2022/11/05 10:41:00 PM
2022/11/05,22:46,54,5,0,5,2022/11/05 10:46:00 PM
2022/11/05,22:33,61,4,1,5,2022/11/05 10:33:00 PM
2022/11/05,22:41,67,3,4,7,2022/11/05 10:41:00 PM
2022/11/05,22:39,10,0,2,2,2022/11/05 10:39:00 PM
2022/11/05,22:38,4,11,20,31,2022/11/05 10:38:00 PM
2022/11/05,22:35,45,4,8,12,2022/11/05 10:35:00 PM
2022/11/05,22:32,31,3,4,7,2022/11/05 10:32:00 PM
2022/11/05,22:44,1,1,5,6,2022/11/05 10:44:00 PM
2022/11/05,22:30,57,0,2,2,2022/11/05 10:30:00 PM
2022/11/05,22:38,28,2,52,54,2022/11/05 10:38:00 PM
2022/11/05,22:39,2,8,0,8,2022/11/05 10:39:00 PM
2022/11/05,22:47,14,9,6,15,2022/11/05 10:47:00 PM
2022/11/05,22:48,45,8,24,32,2022/11/05 10:48:00 PM
2022/11/05,22:39,19,16,13,29,2022/11/05 10:39:00 PM
2022/11/05,22:46,66,6,5,11,2022/11/05 10:46:00 PM
2022/11/05,22:41,58,3,1,4,2022/11/05 10:41:00 PM
2022/11/05,22:27,21,15,2,17,2022/11/05 10:27:00 PM
2022/11/05,22:44,41,25,11,36,2022/11/05 10:44:00 PM
2022/11/05,22:37,27,0,1,1,2022/11/05 10:37:00 PM
2022/11/05,22:42,76,0,1,1,2022/11/05 10:42:00 PM
2022/11/05,22:47,77,2,1,3,2022/11/05 10:47:00 PM
2022/11/05,22:34,50,6,2,8,2022/11/05 10:34:00 PM
2022/11/05,22:42,37,1,1,2,2022/11/05 10:42:00 PM
2022/11/05,22:45,30,10,4,14,2022/11/05 10:45:00 PM
2022/11/05,22:47,28,4,90,94,2022/11/05 10:47:00 PM
2022/11/05,22:41,18,0,1,1,2022/11/05 10:41:00 PM
2022/11/05,22:35,28,0,16,16,2022/11/05 10:35:00 PM
2022/11/05,22:48,65,7,11,18,2022/11/05 10:48:00 PM
2022/11/05,22:49,65,16,21,37,2022/11/05 10:49:00 PM
2022/11/05,22:46,62,1,2,3,2022/11/05 10:46:00 PM
2022/11/05,22:49,29,134,1,135,2022/11/05 10:49:00 PM
2022/11/05,22:46,42,2,1,3,2022/11/05 10:46:00 PM
2022/11/05,22:34,49,3,2,5,2022/11/05 10:34:00 PM
2022/11/05,22:43,41,8,30,38,2022/11/05 10:43:00 PM
2022/11/05,22:44,18,0,1,1,2022/11/05 10:44:00 PM
2022/11/05,22:40,68,1,0,1,2022/11/05 10:40:00 PM
2022/11/05,22:45,47,2,13,15,2022/11/05 10:45:00 PM
2022/11/05,22:40,72,3,8,11,2022/11/05 10:40:00 PM
2022/11/05,22:38,67,2,9,11,2022/11/05 10:38:00 PM
2022/11/05,22:43,46,2,0,2,2022/11/05 10:43:00 PM
2022/11/05,22:44,9,0,1,1,2022/11/05 10:44:00 PM
2022/11/05,22:40,67,8,1,9,2022/11/05 10:40:00 PM
2022/11/05,22:47,8,2,0,2,2022/11/05 10:47:00 PM
2022/11/05,22:33,37,2,8,10,2022/11/05 10:33:00 PM
2022/11/05,22:43,79,6,4,10,2022/11/05 10:43:00 PM
2022/11/05,22:38,47,4,3,7,2022/11/05 10:38:00 PM
2022/11/05,22:41,36,0,5,5,2022/11/05 10:41:00 PM
2022/11/05,22:39,46,1,0,1,2022/11/05 10:39:00 PM
2022/11/05,22:41,27,2,0,2,2022/11/05 10:41:00 PM
2022/11/05,22:35,2,9,3,12,2022/11/05 10:35:00 PM
2022/11/05,22:43,6,31,7,38,2022/11/05 10:43:00 PM
2022/11/05,22:47,79,12,8,20,2022/11/05 10:47:00 PM
2022/11/05,22:42,56,5,3,8,2022/11/05 10:42:00 PM
2022/11/05,22:37,30,17,1,18,2022/11/05 10:37:00 PM
2022/11/05,22:41,68,0,3,3,2022/11/05 10:41:00 PM
2022/11/05,22:46,79,13,4,17,2022/11/05 10:46:00 PM
2022/11/05,22:42,19,7,4,11,2022/11/05 10:42:00 PM
2022/11/05,22:43,14,15,0,15,2022/11/05 10:43:00 PM
2022/11/05,22:40,47,8,8,16,2022/11/05 10:40:00 PM
2022/11/05,22:39,45,25,10,35,2022/11/05 10:39:00 PM
2022/11/05,22:47,51,0,3,3,2022/11/05 10:47:00 PM
2022/11/05,22:48,58,7,2,9,2022/11/05 10:48:00 PM
2022/11/05,22:38,14,5,1,6,2022/11/05 10:38:00 PM
2022/11/05,22:38,1,7,7,14,2022/11/05 10:38:00 PM
2022/11/05,22:33,19,18,9,27,2022/11/05 10:33:00 PM
2022/11/05,22:41,72,11,12,23,2022/11/05 10:41:00 PM
2022/11/05,22:43,65,0,23,23,2022/11/05 10:43:00 PM
2022/11/05,22:45,6,15,20,35,2022/11/05 10:45:00 PM
2022/11/05,22:37,79,8,5,13,2022/11/05 10:37:00 PM
2022/11/05,22:47,4,14,8,22,2022/11/05 10:47:00 PM
2022/11/05,22:39,65,3,13,16,2022/11/05 10:39:00 PM
2022/11/05,22:40,29,116,6,122,2022/11/05 10:40:00 PM
2022/11/05,22:44,70,8,2,10,2022/11/05 10:44:00 PM
2022/11/05,22:44,45,16,14,30,2022/11/05 10:44:00 PM
2022/11/05,22:36,59,2,1,3,2022/11/05 10:36:00 PM
2022/11/05,22:30,37,4,1,5,2022/11/05 10:30:00 PM
2022/11/05,22:45,2,4,0,4,2022/11/05 10:45:00 PM
2022/11/05,22:38,12,6,5,11,2022/11/05 10:38:00 PM
2022/11/05,22:39,12,2,8,10,2022/11/05 10:39:00 PM
2022/11/05,22:34,42,5,0,5,2022/11/05 10:34:00 PM
2022/11/05,22:44,21,4,6,10,2022/11/05 10:44:00 PM
2022/11/05,22:48,8,4,0,4,2022/11/05 10:48:00 PM
2022/11/05,22:36,79,7,2,9,2022/11/05 10:36:00 PM
2022/11/05,22:42,28,1,115,116,2022/11/05 10:42:00 PM
2022/11/05,22:48,59,3,0,3,2022/11/05 10:48:00 PM
2022/11/05,22:40,46,1,2,3,2022/11/05 10:40:00 PM
2022/11/05,22:44,3,5,6,11,2022/11/05 10:44:00 PM
2022/11/05,22:47,50,2,0,2,2022/11/05 10:47:00 PM
2022/11/05,22:45,70,6,0,6,2022/11/05 10:45:00 PM
2022/11/05,22:44,61,2,1,3,2022/11/05 10:44:00 PM
2022/11/05,22:40,40,22,0,22,2022/11/05 10:40:00 PM
2022/11/05,22:31,21,14,22,36,2022/11/05 10:31:00 PM
2022/11/05,22:42,70,17,1,18,2022/11/05 10:42:00 PM
2022/11/05,22:37,77,2,2,4,2022/11/05 10:37:00 PM
2022/11/05,22:31,19,11,16,27,2022/11/05 10:31:00 PM
2022/11/05,22:43,30,12,1,13,2022/11/05 10:43:00 PM
2022/11/05,22:39,79,4,2,6,2022/11/05 10:39:00 PM
2022/11/05,22:41,20,2,3,5,2022/11/05 10:41:00 PM
2022/11/05,22:34,11,0,2,2,2022/11/05 10:34:00 PM
2022/11/05,22:38,58,5,6,11,2022/11/05 10:38:00 PM
2022/11/05,22:42,49,0,4,4,2022/11/05 10:42:00 PM
2022/11/05,22:47,35,59,26,85,2022/11/05 10:47:00 PM
2022/11/05,22:43,9,0,3,3,2022/11/05 10:43:00 PM
2022/11/05,22:37,19,7,10,17,2022/11/05 10:37:00 PM
2022/11/05,22:34,28,5,9,14,2022/11/05 10:34:00 PM
2022/11/05,22:37,46,1,0,1,2022/11/05 10:37:00 PM
2022/11/05,22:46,65,2,35,37,2022/11/05 10:46:00 PM
2022/11/05,22:36,84,2,6,8,2022/11/05 10:36:00 PM
2022/11/05,22:39,66,21,6,27,2022/11/05 10:39:00 PM
2022/11/05,22:37,56,3,0,3,2022/11/05 10:37:00 PM
2022/11/05,22:41,56,5,2,7,2022/11/05 10:41:00 PM
2022/11/05,22:39,11,3,0,3,2022/11/05 10:39:00 PM
2022/11/05,22:39,68,1,3,4,2022/11/05 10:39:00 PM
2022/11/05,22:35,23,2,0,2,2022/11/05 10:35:00 PM
2022/11/05,22:43,51,1,0,1,2022/11/05 10:43:00 PM
2022/11/05,22:34,5,5,7,12,2022/11/05 10:34:00 PM
2022/11/05,22:39,23,1,0,1,2022/11/05 10:39:00 PM
2022/11/05,22:33,21,2,1,3,2022/11/05 10:33:00 PM
2022/11/05,22:45,76,1,0,1,2022/11/05 10:45:00 PM
2022/11/05,22:35,24,0,2,2,2022/11/05 10:35:00 PM
2022/11/05,22:47,2,5,3,8,2022/11/05 10:47:00 PM
2022/11/05,22:49,84,7,14,21,2022/11/05 10:49:00 PM
2022/11/05,22:36,31,3,6,9,2022/11/05 10:36:00 PM
2022/11/05,22:36,86,1,0,1,2022/11/05 10:36:00 PM
2022/11/05,22:45,87,1,0,1,2022/11/05 10:45:00 PM
2022/11/05,22:34,40,2,0,2,2022/11/05 10:34:00 PM
2022/11/05,22:34,36,7,0,7,2022/11/05 10:34:00 PM
2022/11/05,22:37,40,27,0,27,2022/11/05 10:37:00 PM
2022/11/05,22:41,51,2,0,2,2022/11/05 10:41:00 PM
2022/11/05,22:34,2,7,0,7,2022/11/05 10:34:00 PM
2022/11/05,22:38,9,1,0,1,2022/11/05 10:38:00 PM
2022/11/05,22:42,4,15,7,22,2022/11/05 10:42:00 PM
2022/11/05,22:45,62,1,2,3,2022/11/05 10:45:00 PM
2022/11/05,22:41,50,7,2,9,2022/11/05 10:41:00 PM
2022/11/05,22:49,2,5,8,13,2022/11/05 10:49:00 PM
2022/11/05,22:38,79,9,5,14,2022/11/05 10:38:00 PM
2022/11/05,22:35,21,10,2,12,2022/11/05 10:35:00 PM
2022/11/05,22:32,19,7,4,11,2022/11/05 10:32:00 PM
2022/11/05,22:40,79,1,2,3,2022/11/05 10:40:00 PM
2022/11/05,22:42,27,2,0,2,2022/11/05 10:42:00 PM
2022/11/05,22:42,65,6,22,28,2022/11/05 10:42:00 PM
2022/11/05,22:35,72,3,0,3,2022/11/05 10:35:00 PM
2022/11/05,22:43,54,0,1,1,2022/11/05 10:43:00 PM
2022/11/05,22:37,35,44,18,62,2022/11/05 10:37:00 PM
2022/11/05,22:47,10,1,0,1,2022/11/05 10:47:00 PM
2022/11/05,22:45,63,22,7,29,2022/11/05 10:45:00 PM
2022/11/05,22:48,63,5,9,14,2022/11/05 10:48:00 PM
2022/11/05,22:38,56,1,4,5,2022/11/05 10:38:00 PM
2022/11/05,22:44,35,35,10,45,2022/11/05 10:44:00 PM
2022/11/05,22:35,84,8,6,14,2022/11/05 10:35:00 PM
2022/11/05,22:42,2,2,0,2,2022/11/05 10:42:00 PM
2022/11/05,22:41,47,10,5,15,2022/11/05 10:41:00 PM
2022/11/05,22:36,77,3,1,4,2022/11/05 10:36:00 PM
2022/11/05,22:34,24,7,0,7,2022/11/05 10:34:00 PM
2022/11/05,22:43,4,4,9,13,2022/11/05 10:43:00 PM
2022/11/05,22:59,35,21,6,27,2022/11/05 10:59:00 PM
2022/11/05,23:02,3,7,16,23,2022/11/05 11:02:00 PM
2022/11/05,23:01,86,4,0,4,2022/11/05 11:01:00 PM
2022/11/05,23:03,24,5,10,15,2022/11/05 11:03:00 PM
2022/11/05,22:59,87,1,2,3,2022/11/05 10:59:00 PM
2022/11/05,23:01,47,13,4,17,2022/11/05 11:01:00 PM
2022/11/05,23:00,23,1,1,2,2022/11/05 11:00:00 PM
2022/11/05,22:57,72,11,15,26,2022/11/05 10:57:00 PM
2022/11/05,22:56,6,17,1,18,2022/11/05 10:56:00 PM
2022/11/05,22:55,67,3,8,11,2022/11/05 10:55:00 PM
2022/11/05,22:41,44,1,0,1,2022/11/05 10:41:00 PM
2022/11/05,23:02,59,8,1,9,2022/11/05 11:02:00 PM
2022/11/05,22:55,50,10,5,15,2022/11/05 10:55:00 PM
2022/11/05,22:55,29,79,6,85,2022/11/05 10:55:00 PM
2022/11/05,22:50,36,0,1,1,2022/11/05 10:50:00 PM
2022/11/05,22:52,43,0,3,3,2022/11/05 10:52:00 PM
2022/11/05,22:58,36,3,2,5,2022/11/05 10:58:00 PM
2022/11/05,22:56,1,8,2,10,2022/11/05 10:56:00 PM
2022/11/05,23:02,47,18,4,22,2022/11/05 11:02:00 PM
2022/11/05,22:48,47,6,16,22,2022/11/05 10:48:00 PM
2022/11/05,22:50,44,0,4,4,2022/11/05 10:50:00 PM
2022/11/05,22:51,61,7,1,8,2022/11/05 10:51:00 PM
2022/11/05,22:53,63,9,0,9,2022/11/05 10:53:00 PM
2022/11/05,22:57,36,0,3,3,2022/11/05 10:57:00 PM
2022/11/05,22:47,21,6,13,19,2022/11/05 10:47:00 PM
2022/11/05,22:55,54,2,2,4,2022/11/05 10:55:00 PM
2022/11/05,22:51,39,0,4,4,2022/11/05 10:51:00 PM
2022/11/05,22:55,77,0,1,1,2022/11/05 10:55:00 PM
2022/11/05,22:59,59,3,0,3,2022/11/05 10:59:00 PM
2022/11/05,22:51,24,16,0,16,2022/11/05 10:51:00 PM
2022/11/05,22:50,8,1,4,5,2022/11/05 10:50:00 PM
2022/11/05,22:52,57,1,0,1,2022/11/05 10:52:00 PM
2022/11/05,22:44,20,11,10,21,2022/11/05 10:44:00 PM
2022/11/05,23:02,20,16,5,21,2022/11/05 11:02:00 PM
2022/11/05,22:55,2,2,0,2,2022/11/05 10:55:00 PM
2022/11/05,23:03,63,3,12,15,2022/11/05 11:03:00 PM
2022/11/05,23:03,4,25,17,42,2022/11/05 11:03:00 PM
2022/11/05,22:50,47,12,7,19,2022/11/05 10:50:00 PM
2022/11/05,22:48,31,16,8,24,2022/11/05 10:48:00 PM
2022/11/05,22:59,67,4,6,10,2022/11/05 10:59:00 PM
2022/11/05,22:50,31,5,5,10,2022/11/05 10:50:00 PM
2022/11/05,22:58,1,4,0,4,2022/11/05 10:58:00 PM
2022/11/05,22:57,28,1,41,42,2022/11/05 10:57:00 PM
2022/11/05,22:58,65,0,6,6,2022/11/05 10:58:00 PM
2022/11/05,22:55,27,0,7,7,2022/11/05 10:55:00 PM
2022/11/05,22:51,23,12,1,13,2022/11/05 10:51:00 PM
2022/11/05,22:49,11,0,3,3,2022/11/05 10:49:00 PM
2022/11/05,22:46,36,3,4,7,2022/11/05 10:46:00 PM
2022/11/05,22:50,54,2,0,2,2022/11/05 10:50:00 PM
2022/11/05,23:02,24,7,6,13,2022/11/05 11:02:00 PM
2022/11/05,22:52,70,2,0,2,2022/11/05 10:52:00 PM
2022/11/05,23:01,14,2,0,2,2022/11/05 11:01:00 PM
2022/11/05,23:00,50,2,3,5,2022/11/05 11:00:00 PM
2022/11/05,22:50,1,0,9,9,2022/11/05 10:50:00 PM
2022/11/05,23:00,9,0,1,1,2022/11/05 11:00:00 PM
2022/11/05,22:46,37,0,12,12,2022/11/05 10:46:00 PM
2022/11/05,22:52,79,33,7,40,2022/11/05 10:52:00 PM
2022/11/05,23:03,45,10,1,11,2022/11/05 11:03:00 PM
2022/11/05,22:53,62,0,2,2,2022/11/05 10:53:00 PM
2022/11/05,23:00,76,1,0,1,2022/11/05 11:00:00 PM
2022/11/05,22:51,11,0,1,1,2022/11/05 10:51:00 PM
2022/11/05,22:50,9,0,3,3,2022/11/05 10:50:00 PM
2022/11/05,22:57,20,17,5,22,2022/11/05 10:57:00 PM
2022/11/05,22:50,49,0,5,5,2022/11/05 10:50:00 PM
2022/11/05,22:56,24,0,10,10,2022/11/05 10:56:00 PM
2022/11/05,22:55,72,2,20,22,2022/11/05 10:55:00 PM
2022/11/05,22:56,58,1,7,8,2022/11/05 10:56:00 PM
2022/11/05,22:57,6,27,9,36,2022/11/05 10:57:00 PM
2022/11/05,23:03,49,4,0,4,2022/11/05 11:03:00 PM
2022/11/05,23:03,8,2,0,2,2022/11/05 11:03:00 PM
2022/11/05,22:56,63,5,4,9,2022/11/05 10:56:00 PM
2022/11/05,23:00,51,1,2,3,2022/11/05 11:00:00 PM
2022/11/05,22:59,62,0,6,6,2022/11/05 10:59:00 PM
2022/11/05,22:54,5,6,6,12,2022/11/05 10:54:00 PM
2022/11/05,22:52,36,4,3,7,2022/11/05 10:52:00 PM
2022/11/05,22:51,2,6,2,8,2022/11/05 10:51:00 PM
2022/11/05,23:01,67,14,2,16,2022/11/05 11:01:00 PM
2022/11/05,22:51,36,0,4,4,2022/11/05 10:51:00 PM
2022/11/05,22:49,24,4,6,10,2022/11/05 10:49:00 PM
2022/11/05,22:52,6,22,22,44,2022/11/05 10:52:00 PM
2022/11/05,22:59,54,0,1,1,2022/11/05 10:59:00 PM
2022/11/05,23:00,84,15,7,22,2022/11/05 11:00:00 PM
2022/11/05,22:53,54,4,0,4,2022/11/05 10:53:00 PM
2022/11/05,22:55,44,0,1,1,2022/11/05 10:55:00 PM
2022/11/05,23:00,54,0,4,4,2022/11/05 11:00:00 PM
2022/11/05,22:57,39,1,0,1,2022/11/05 10:57:00 PM
2022/11/05,22:53,23,2,0,2,2022/11/05 10:53:00 PM
2022/11/05,22:52,4,21,12,33,2022/11/05 10:52:00 PM
2022/11/05,22:51,63,8,3,11,2022/11/05 10:51:00 PM
2022/11/05,22:59,42,2,2,4,2022/11/05 10:59:00 PM
2022/11/05,23:02,11,0,3,3,2022/11/05 11:02:00 PM
2022/11/05,22:59,27,0,1,1,2022/11/05 10:59:00 PM
2022/11/05,23:00,87,0,1,1,2022/11/05 11:00:00 PM
2022/11/05,23:01,54,1,0,1,2022/11/05 11:01:00 PM
2022/11/05,22:57,59,7,0,7,2022/11/05 10:57:00 PM
2022/11/05,22:50,35,84,14,98,2022/11/05 10:50:00 PM
2022/11/05,22:59,66,7,13,20,2022/11/05 10:59:00 PM
2022/11/05,23:01,35,39,19,58,2022/11/05 11:01:00 PM
2022/11/05,22:53,79,19,3,22,2022/11/05 10:53:00 PM
2022/11/05,22:56,36,2,2,4,2022/11/05 10:56:00 PM
2022/11/05,22:56,28,0,28,28,2022/11/05 10:56:00 PM
2022/11/05,22:51,47,8,20,28,2022/11/05 10:51:00 PM
2022/11/05,22:53,61,1,3,4,2022/11/05 10:53:00 PM
2022/11/05,22:59,3,3,8,11,2022/11/05 10:59:00 PM
2022/11/05,22:50,58,1,0,1,2022/11/05 10:50:00 PM
2022/11/05,22:50,12,1,0,1,2022/11/05 10:50:00 PM
2022/11/05,22:53,28,5,50,55,2022/11/05 10:53:00 PM
2022/11/05,22:47,20,20,3,23,2022/11/05 10:47:00 PM
2022/11/05,22:52,56,1,4,5,2022/11/05 10:52:00 PM
2022/11/05,22:50,28,2,46,48,2022/11/05 10:50:00 PM
2022/11/05,23:02,56,8,8,16,2022/11/05 11:02:00 PM
2022/11/05,22:51,65,3,16,19,2022/11/05 10:51:00 PM
2022/11/05,22:55,45,8,6,14,2022/11/05 10:55:00 PM
2022/11/05,23:01,1,2,8,10,2022/11/05 11:01:00 PM
2022/11/05,22:51,45,13,21,34,2022/11/05 10:51:00 PM
2022/11/05,22:51,50,5,2,7,2022/11/05 10:51:00 PM
2022/11/05,22:57,24,3,4,7,2022/11/05 10:57:00 PM
2022/11/05,22:49,61,2,0,2,2022/11/05 10:49:00 PM
2022/11/05,23:03,27,1,9,10,2022/11/05 11:03:00 PM
2022/11/05,22:52,47,15,9,24,2022/11/05 10:52:00 PM
2022/11/05,22:58,24,4,4,8,2022/11/05 10:58:00 PM
2022/11/05,22:54,79,14,5,19,2022/11/05 10:54:00 PM
2022/11/05,22:53,48,0,1,1,2022/11/05 10:53:00 PM
2022/11/05,22:58,62,0,3,3,2022/11/05 10:58:00 PM
2022/11/05,23:00,67,6,6,12,2022/11/05 11:00:00 PM
2022/11/05,23:02,18,0,3,3,2022/11/05 11:02:00 PM
2022/11/05,23:00,12,2,4,6,2022/11/05 11:00:00 PM
2022/11/05,23:02,41,24,18,42,2022/11/05 11:02:00 PM
2022/11/05,22:51,31,1,14,15,2022/11/05 10:51:00 PM
2022/11/05,22:51,8,0,1,1,2022/11/05 10:51:00 PM
2022/11/05,22:51,48,4,0,4,2022/11/05 10:51:00 PM
2022/11/05,22:55,6,13,18,31,2022/11/05 10:55:00 PM
2022/11/05,23:03,54,1,1,2,2022/11/05 11:03:00 PM
2022/11/05,23:00,20,11,5,16,2022/11/05 11:00:00 PM
2022/11/05,22:48,21,19,19,38,2022/11/05 10:48:00 PM
2022/11/05,22:59,51,1,0,1,2022/11/05 10:59:00 PM
2022/11/05,23:04,2,4,0,4,2022/11/05 11:04:00 PM
2022/11/05,22:59,4,15,6,21,2022/11/05 10:59:00 PM
2022/11/05,22:51,58,1,3,4,2022/11/05 10:51:00 PM
2022/11/05,22:58,44,2,1,3,2022/11/05 10:58:00 PM
2022/11/05,22:56,47,6,3,9,2022/11/05 10:56:00 PM
2022/11/05,22:56,61,4,6,10,2022/11/05 10:56:00 PM
2022/11/05,22:49,42,3,0,3,2022/11/05 10:49:00 PM
2022/11/05,22:45,61,0,6,6,2022/11/05 10:45:00 PM
2022/11/05,23:03,70,4,0,4,2022/11/05 11:03:00 PM
2022/11/05,22:52,11,1,0,1,2022/11/05 10:52:00 PM
2022/11/05,22:50,30,17,5,22,2022/11/05 10:50:00 PM
2022/11/05,22:55,18,0,2,2,2022/11/05 10:55:00 PM
2022/11/05,22:54,12,0,3,3,2022/11/05 10:54:00 PM
2022/11/05,22:51,85,1,0,1,2022/11/05 10:51:00 PM
2022/11/05,23:00,28,1,15,16,2022/11/05 11:00:00 PM
2022/11/05,22:53,84,14,3,17,2022/11/05 10:53:00 PM
2022/11/05,23:01,28,2,61,63,2022/11/05 11:01:00 PM
2022/11/05,22:48,40,2,2,4,2022/11/05 10:48:00 PM
2022/11/05,22:49,4,26,6,32,2022/11/05 10:49:00 PM
2022/11/05,22:51,19,14,5,19,2022/11/05 10:51:00 PM
2022/11/05,22:50,63,5,6,11,2022/11/05 10:50:00 PM
2022/11/05,22:54,67,2,13,15,2022/11/05 10:54:00 PM
2022/11/05,22:47,31,7,6,13,2022/11/05 10:47:00 PM
2022/11/05,22:53,57,1,0,1,2022/11/05 10:53:00 PM
2022/11/05,22:54,19,6,7,13,2022/11/05 10:54:00 PM
2022/11/05,22:51,28,0,61,61,2022/11/05 10:51:00 PM
2022/11/05,22:50,62,4,1,5,2022/11/05 10:50:00 PM
2022/11/05,23:02,72,3,9,12,2022/11/05 11:02:00 PM
2022/11/05,22:58,40,0,1,1,2022/11/05 10:58:00 PM
2022/11/05,22:49,28,0,66,66,2022/11/05 10:49:00 PM
2022/11/05,23:03,29,64,1,65,2022/11/05 11:03:00 PM
2022/11/05,22:45,23,2,2,4,2022/11/05 10:45:00 PM
2022/11/05,23:02,10,0,1,1,2022/11/05 11:02:00 PM
2022/11/05,22:57,49,1,0,1,2022/11/05 10:57:00 PM
2022/11/05,22:57,40,1,0,1,2022/11/05 10:57:00 PM
2022/11/05,22:54,2,6,4,10,2022/11/05 10:54:00 PM
2022/11/05,22:58,4,29,8,37,2022/11/05 10:58:00 PM
2022/11/05,22:55,30,8,8,16,2022/11/05 10:55:00 PM
2022/11/05,22:55,66,22,4,26,2022/11/05 10:55:00 PM
2022/11/05,22:51,62,0,1,1,2022/11/05 10:51:00 PM
2022/11/05,23:00,40,5,0,5,2022/11/05 11:00:00 PM
2022/11/05,23:00,2,4,2,6,2022/11/05 11:00:00 PM
2022/11/05,22:56,39,2,0,2,2022/11/05 10:56:00 PM
2022/11/05,23:01,41,34,13,47,2022/11/05 11:01:00 PM
2022/11/05,22:48,23,0,1,1,2022/11/05 10:48:00 PM
2022/11/05,22:57,62,0,6,6,2022/11/05 10:57:00 PM
2022/11/05,22:59,45,6,4,10,2022/11/05 10:59:00 PM
2022/11/05,22:59,30,5,7,12,2022/11/05 10:59:00 PM
2022/11/05,23:03,87,1,3,4,2022/11/05 11:03:00 PM
2022/11/05,22:53,37,1,12,13,2022/11/05 10:53:00 PM
2022/11/05,22:59,63,4,6,10,2022/11/05 10:59:00 PM
2022/11/05,22:55,49,2,0,2,2022/11/05 10:55:00 PM
2022/11/05,22:55,21,6,12,18,2022/11/05 10:55:00 PM
2022/11/05,22:57,43,9,0,9,2022/11/05 10:57:00 PM
2022/11/05,22:55,36,1,6,7,2022/11/05 10:55:00 PM
2022/11/05,22:48,19,7,0,7,2022/11/05 10:48:00 PM
2022/11/05,23:02,27,0,2,2,2022/11/05 11:02:00 PM
2022/11/05,22:51,9,1,0,1,2022/11/05 10:51:00 PM
2022/11/05,22:50,21,1,13,14,2022/11/05 10:50:00 PM
2022/11/05,22:53,51,0,1,1,2022/11/05 10:53:00 PM
2022/11/05,22:53,1,2,3,5,2022/11/05 10:53:00 PM
2022/11/05,22:58,9,2,0,2,2022/11/05 10:58:00 PM
2022/11/05,22:57,77,3,4,7,2022/11/05 10:57:00 PM
2022/11/05,22:52,21,13,12,25,2022/11/05 10:52:00 PM
2022/11/05,22:55,5,14,4,18,2022/11/05 10:55:00 PM
2022/11/05,22:49,85,1,3,4,2022/11/05 10:49:00 PM
2022/11/05,22:48,48,1,2,3,2022/11/05 10:48:00 PM
2022/11/05,22:58,47,6,4,10,2022/11/05 10:58:00 PM
2022/11/05,22:50,72,2,6,8,2022/11/05 10:50:00 PM
2022/11/05,22:55,4,15,4,19,2022/11/05 10:55:00 PM
2022/11/05,22:51,87,1,0,1,2022/11/05 10:51:00 PM
2022/11/05,23:01,87,2,3,5,2022/11/05 11:01:00 PM
2022/11/05,22:56,51,2,5,7,2022/11/05 10:56:00 PM
2022/11/05,22:48,20,5,1,6,2022/11/05 10:48:00 PM
2022/11/05,22:59,11,1,1,2,2022/11/05 10:59:00 PM
2022/11/05,22:55,56,3,6,9,2022/11/05 10:55:00 PM
2022/11/05,23:02,36,1,6,7,2022/11/05 11:02:00 PM
2022/11/05,22:52,35,69,7,76,2022/11/05 10:52:00 PM
2022/11/05,22:59,28,4,28,32,2022/11/05 10:59:00 PM
2022/11/05,23:03,36,0,7,7,2022/11/05 11:03:00 PM
2022/11/05,22:55,14,2,5,7,2022/11/05 10:55:00 PM
2022/11/05,23:00,6,15,9,24,2022/11/05 11:00:00 PM
2022/11/05,22:59,77,0,1,1,2022/11/05 10:59:00 PM
2022/11/05,22:53,56,6,0,6,2022/11/05 10:53:00 PM
2022/11/05,22:50,84,15,13,28,2022/11/05 10:50:00 PM
2022/11/05,22:54,20,7,0,7,2022/11/05 10:54:00 PM
2022/11/05,22:58,84,8,9,17,2022/11/05 10:58:00 PM
2022/11/05,23:01,11,0,3,3,2022/11/05 11:01:00 PM
2022/11/05,22:54,42,1,0,1,2022/11/05 10:54:00 PM
2022/11/05,22:57,50,7,1,8,2022/11/05 10:57:00 PM
2022/11/05,22:46,61,2,2,4,2022/11/05 10:46:00 PM
2022/11/05,22:49,18,3,0,3,2022/11/05 10:49:00 PM
2022/11/05,22:50,45,7,8,15,2022/11/05 10:50:00 PM
2022/11/05,22:55,84,6,28,34,2022/11/05 10:55:00 PM
2022/11/05,22:54,41,13,25,38,2022/11/05 10:54:00 PM
2022/11/05,22:54,68,1,2,3,2022/11/05 10:54:00 PM
2022/11/05,22:58,46,1,1,2,2022/11/05 10:58:00 PM
2022/11/05,22:57,69,1,0,1,2022/11/05 10:57:00 PM
2022/11/05,22:52,65,13,17,30,2022/11/05 10:52:00 PM
2022/11/05,22:49,5,12,19,31,2022/11/05 10:49:00 PM
2022/11/05,23:02,1,5,0,5,2022/11/05 11:02:00 PM
2022/11/05,23:02,14,8,1,9,2022/11/05 11:02:00 PM
2022/11/05,22:53,68,0,1,1,2022/11/05 10:53:00 PM
2022/11/05,22:57,47,8,5,13,2022/11/05 10:57:00 PM
2022/11/05,22:55,20,7,5,12,2022/11/05 10:55:00 PM
2022/11/05,22:46,5,9,16,25,2022/11/05 10:46:00 PM
2022/11/05,22:59,12,1,6,7,2022/11/05 10:59:00 PM
2022/11/05,22:55,11,0,1,1,2022/11/05 10:55:00 PM
2022/11/05,22:55,35,64,26,90,2022/11/05 10:55:00 PM
2022/11/05,23:00,11,2,0,2,2022/11/05 11:00:00 PM
2022/11/05,22:53,24,4,0,4,2022/11/05 10:53:00 PM
2022/11/05,22:53,11,3,2,5,2022/11/05 10:53:00 PM
2022/11/05,22:47,37,6,10,16,2022/11/05 10:47:00 PM
2022/11/05,23:02,50,9,1,10,2022/11/05 11:02:00 PM
2022/11/05,22:59,84,10,10,20,2022/11/05 10:59:00 PM
2022/11/05,22:54,37,2,2,4,2022/11/05 10:54:00 PM
2022/11/05,22:51,40,2,3,5,2022/11/05 10:51:00 PM
2022/11/05,23:02,79,7,16,23,2022/11/05 11:02:00 PM
2022/11/05,22:55,76,0,2,2,2022/11/05 10:55:00 PM
2022/11/05,22:56,11,0,1,1,2022/11/05 10:56:00 PM
2022/11/05,22:59,50,5,0,5,2022/11/05 10:59:00 PM
2022/11/05,23:00,65,2,20,22,2022/11/05 11:00:00 PM
2022/11/05,22:50,19,13,1,14,2022/11/05 10:50:00 PM
2022/11/05,23:01,3,18,15,33,2022/11/05 11:01:00 PM
2022/11/05,23:00,35,26,20,46,2022/11/05 11:00:00 PM
2022/11/05,23:03,56,3,0,3,2022/11/05 11:03:00 PM
2022/11/05,23:04,79,11,4,15,2022/11/05 11:04:00 PM
2022/11/05,22:51,21,6,1,7,2022/11/05 10:51:00 PM
2022/11/05,22:54,45,4,10,14,2022/11/05 10:54:00 PM
2022/11/05,22:49,63,13,6,19,2022/11/05 10:49:00 PM
2022/11/05,22:52,61,1,2,3,2022/11/05 10:52:00 PM
2022/11/05,23:00,36,2,4,6,2022/11/05 11:00:00 PM
2022/11/05,22:56,10,0,2,2,2022/11/05 10:56:00 PM
2022/11/05,22:56,4,37,12,49,2022/11/05 10:56:00 PM
2022/11/05,22:59,58,5,1,6,2022/11/05 10:59:00 PM
2022/11/05,23:03,12,4,2,6,2022/11/05 11:03:00 PM
2022/11/05,22:54,27,1,0,1,2022/11/05 10:54:00 PM
2022/11/05,23:00,77,1,0,1,2022/11/05 11:00:00 PM
2022/11/05,22:52,31,2,8,10,2022/11/05 10:52:00 PM
2022/11/05,22:54,62,0,2,2,2022/11/05 10:54:00 PM
2022/11/05,23:03,47,14,14,28,2022/11/05 11:03:00 PM
2022/11/05,22:58,63,11,2,13,2022/11/05 10:58:00 PM
2022/11/05,22:50,61,1,0,1,2022/11/05 10:50:00 PM
2022/11/05,23:00,4,25,11,36,2022/11/05 11:00:00 PM
2022/11/05,23:01,45,3,11,14,2022/11/05 11:01:00 PM
2022/11/05,22:56,62,1,1,2,2022/11/05 10:56:00 PM
2022/11/05,22:48,36,3,4,7,2022/11/05 10:48:00 PM
2022/11/05,22:58,86,1,0,1,2022/11/05 10:58:00 PM
2022/11/05,22:58,77,2,0,2,2022/11/05 10:58:00 PM
2022/11/05,23:04,84,10,15,25,2022/11/05 11:04:00 PM
2022/11/05,23:02,9,5,0,5,2022/11/05 11:02:00 PM
2022/11/05,23:03,1,7,3,10,2022/11/05 11:03:00 PM
2022/11/05,23:01,29,30,3,33,2022/11/05 11:01:00 PM
2022/11/05,22:51,54,0,2,2,2022/11/05 10:51:00 PM
2022/11/05,22:58,10,0,2,2,2022/11/05 10:58:00 PM
2022/11/05,22:57,30,6,9,15,2022/11/05 10:57:00 PM
2022/11/05,22:53,14,9,3,12,2022/11/05 10:53:00 PM
2022/11/05,22:57,3,19,14,33,2022/11/05 10:57:00 PM
2022/11/05,22:49,1,9,2,11,2022/11/05 10:49:00 PM
2022/11/05,22:58,68,0,1,1,2022/11/05 10:58:00 PM
2022/11/05,22:49,30,20,11,31,2022/11/05 10:49:00 PM
2022/11/05,22:50,14,16,7,23,2022/11/05 10:50:00 PM
2022/11/05,22:52,40,3,1,4,2022/11/05 10:52:00 PM
2022/11/05,22:58,30,2,6,8,2022/11/05 10:58:00 PM
2022/11/05,23:02,62,1,2,3,2022/11/05 11:02:00 PM
2022/11/05,22:55,31,4,11,15,2022/11/05 10:55:00 PM
2022/11/05,23:00,72,1,26,27,2022/11/05 11:00:00 PM
2022/11/05,23:01,56,1,0,1,2022/11/05 11:01:00 PM
2022/11/05,22:54,1,2,1,3,2022/11/05 10:54:00 PM
2022/11/05,22:58,59,5,4,9,2022/11/05 10:58:00 PM
2022/11/05,22:49,20,7,1,8,2022/11/05 10:49:00 PM
2022/11/05,22:56,49,0,1,1,2022/11/05 10:56:00 PM
2022/11/05,22:58,29,75,16,91,2022/11/05 10:58:00 PM
2022/11/05,22:54,6,11,9,20,2022/11/05 10:54:00 PM
2022/11/05,23:01,51,2,1,3,2022/11/05 11:01:00 PM
2022/11/05,22:52,72,6,19,25,2022/11/05 10:52:00 PM
2022/11/05,22:49,21,7,9,16,2022/11/05 10:49:00 PM
2022/11/05,23:03,69,1,0,1,2022/11/05 11:03:00 PM
2022/11/05,23:02,42,1,0,1,2022/11/05 11:02:00 PM
2022/11/05,22:54,36,13,6,19,2022/11/05 10:54:00 PM
2022/11/05,22:55,19,4,13,17,2022/11/05 10:55:00 PM
2022/11/05,23:03,79,11,7,18,2022/11/05 11:03:00 PM
2022/11/05,23:03,2,6,1,7,2022/11/05 11:03:00 PM
2022/11/05,22:56,56,1,1,2,2022/11/05 10:56:00 PM
2022/11/05,22:49,57,1,1,2,2022/11/05 10:49:00 PM
2022/11/05,23:00,58,2,4,6,2022/11/05 11:00:00 PM
2022/11/05,22:58,3,12,4,16,2022/11/05 10:58:00 PM
2022/11/05,23:02,67,2,3,5,2022/11/05 11:02:00 PM
2022/11/05,22:53,19,4,15,19,2022/11/05 10:53:00 PM
2022/11/05,22:52,19,17,8,25,2022/11/05 10:52:00 PM
2022/11/05,22:57,87,1,2,3,2022/11/05 10:57:00 PM
2022/11/05,23:00,66,4,6,10,2022/11/05 11:00:00 PM
2022/11/05,22:51,29,139,4,143,2022/11/05 10:51:00 PM
2022/11/05,22:53,86,1,0,1,2022/11/05 10:53:00 PM
2022/11/05,22:49,49,1,1,2,2022/11/05 10:49:00 PM
2022/11/05,23:01,63,2,1,3,2022/11/05 11:01:00 PM
2022/11/05,22:54,28,0,41,41,2022/11/05 10:54:00 PM
2022/11/05,23:04,6,10,4,14,2022/11/05 11:04:00 PM
2022/11/05,22:54,72,6,9,15,2022/11/05 10:54:00 PM
2022/11/05,22:54,30,3,11,14,2022/11/05 10:54:00 PM
2022/11/05,22:57,1,5,1,6,2022/11/05 10:57:00 PM
2022/11/05,22:55,61,3,7,10,2022/11/05 10:55:00 PM
2022/11/05,22:57,56,3,0,3,2022/11/05 10:57:00 PM
2022/11/05,23:02,58,0,1,1,2022/11/05 11:02:00 PM
2022/11/05,22:57,19,6,11,17,2022/11/05 10:57:00 PM
2022/11/05,23:00,3,14,10,24,2022/11/05 11:00:00 PM
2022/11/05,22:50,77,0,1,1,2022/11/05 10:50:00 PM
2022/11/05,22:53,29,63,15,78,2022/11/05 10:53:00 PM
2022/11/05,22:51,84,9,10,19,2022/11/05 10:51:00 PM
2022/11/05,22:54,31,1,12,13,2022/11/05 10:54:00 PM
2022/11/05,22:55,58,3,3,6,2022/11/05 10:55:00 PM
2022/11/05,23:02,40,1,0,1,2022/11/05 11:02:00 PM
2022/11/05,22:52,30,10,12,22,2022/11/05 10:52:00 PM
2022/11/05,23:01,62,1,3,4,2022/11/05 11:01:00 PM
2022/11/05,22:54,63,5,16,21,2022/11/05 10:54:00 PM
2022/11/05,22:59,61,6,3,9,2022/11/05 10:59:00 PM
2022/11/05,22:50,67,9,6,15,2022/11/05 10:50:00 PM
2022/11/05,22:58,28,8,23,31,2022/11/05 10:58:00 PM
2022/11/05,22:50,46,1,1,2,2022/11/05 10:50:00 PM
2022/11/05,22:49,45,16,14,30,2022/11/05 10:49:00 PM
2022/11/05,23:01,12,3,0,3,2022/11/05 11:01:00 PM
2022/11/05,22:51,68,2,4,6,2022/11/05 10:51:00 PM
2022/11/05,22:57,48,0,1,1,2022/11/05 10:57:00 PM
2022/11/05,22:57,61,0,2,2,2022/11/05 10:57:00 PM
2022/11/05,22:52,66,6,11,17,2022/11/05 10:52:00 PM
2022/11/05,22:52,24,4,6,10,2022/11/05 10:52:00 PM
2022/11/05,23:02,29,32,4,36,2022/11/05 11:02:00 PM
2022/11/05,22:53,21,2,5,7,2022/11/05 10:53:00 PM
2022/11/05,23:00,41,28,16,44,2022/11/05 11:00:00 PM
2022/11/05,22:55,87,0,2,2,2022/11/05 10:55:00 PM
2022/11/05,22:52,20,0,3,3,2022/11/05 10:52:00 PM
2022/11/05,22:51,59,1,0,1,2022/11/05 10:51:00 PM
2022/11/05,22:57,66,3,7,10,2022/11/05 10:57:00 PM
2022/11/05,22:52,77,3,0,3,2022/11/05 10:52:00 PM
2022/11/05,22:57,84,24,7,31,2022/11/05 10:57:00 PM
2022/11/05,22:55,65,9,6,15,2022/11/05 10:55:00 PM
2022/11/05,22:50,6,14,6,20,2022/11/05 10:50:00 PM
2022/11/05,22:53,5,16,13,29,2022/11/05 10:53:00 PM
2022/11/05,22:52,63,6,8,14,2022/11/05 10:52:00 PM
2022/11/05,23:04,3,11,6,17,2022/11/05 11:04:00 PM
2022/11/05,22:59,2,0,3,3,2022/11/05 10:59:00 PM
2022/11/05,22:58,12,3,1,4,2022/11/05 10:58:00 PM
2022/11/05,22:50,56,7,0,7,2022/11/05 10:50:00 PM
2022/11/05,23:02,70,0,2,2,2022/11/05 11:02:00 PM
2022/11/05,23:03,42,1,0,1,2022/11/05 11:03:00 PM
2022/11/05,23:02,77,1,3,4,2022/11/05 11:02:00 PM
2022/11/05,22:58,5,10,16,26,2022/11/05 10:58:00 PM
2022/11/05,22:59,23,3,0,3,2022/11/05 10:59:00 PM
2022/11/05,22:59,9,2,1,3,2022/11/05 10:59:00 PM
2022/11/05,22:55,23,1,2,3,2022/11/05 10:55:00 PM
2022/11/05,23:04,14,16,0,16,2022/11/05 11:04:00 PM
2022/11/05,22:55,62,1,0,1,2022/11/05 10:55:00 PM
2022/11/05,22:51,56,2,0,2,2022/11/05 10:51:00 PM
2022/11/05,22:55,28,7,36,43,2022/11/05 10:55:00 PM
2022/11/05,22:52,29,109,1,110,2022/11/05 10:52:00 PM
2022/11/05,22:54,4,12,3,15,2022/11/05 10:54:00 PM
2022/11/05,23:03,65,0,14,14,2022/11/05 11:03:00 PM
2022/11/05,22:49,56,1,12,13,2022/11/05 10:49:00 PM
2022/11/05,22:56,30,12,10,22,2022/11/05 10:56:00 PM
2022/11/05,23:02,4,17,16,33,2022/11/05 11:02:00 PM
2022/11/05,23:00,59,8,4,12,2022/11/05 11:00:00 PM
2022/11/05,22:51,79,16,4,20,2022/11/05 10:51:00 PM
2022/11/05,22:51,3,16,19,35,2022/11/05 10:51:00 PM
2022/11/05,22:49,6,17,13,30,2022/11/05 10:49:00 PM
2022/11/05,22:51,12,0,3,3,2022/11/05 10:51:00 PM
2022/11/05,22:50,3,3,16,19,2022/11/05 10:50:00 PM
2022/11/05,23:03,51,2,2,4,2022/11/05 11:03:00 PM
2022/11/05,22:58,2,10,0,10,2022/11/05 10:58:00 PM
2022/11/05,23:01,30,18,9,27,2022/11/05 11:01:00 PM
2022/11/05,22:58,79,11,0,11,2022/11/05 10:58:00 PM
2022/11/05,22:55,47,13,1,14,2022/11/05 10:55:00 PM
2022/11/05,22:53,4,35,12,47,2022/11/05 10:53:00 PM
2022/11/05,22:57,58,4,5,9,2022/11/05 10:57:00 PM
2022/11/05,22:59,41,26,12,38,2022/11/05 10:59:00 PM
2022/11/05,22:56,14,13,0,13,2022/11/05 10:56:00 PM
2022/11/05,23:01,2,9,2,11,2022/11/05 11:01:00 PM
2022/11/05,22:44,44,1,0,1,2022/11/05 10:44:00 PM
2022/11/05,22:46,20,15,8,23,2022/11/05 10:46:00 PM
2022/11/05,22:53,77,1,0,1,2022/11/05 10:53:00 PM
2022/11/05,22:57,41,29,15,44,2022/11/05 10:57:00 PM
2022/11/05,22:49,37,8,1,9,2022/11/05 10:49:00 PM
2022/11/05,22:54,24,10,5,15,2022/11/05 10:54:00 PM
2022/11/05,22:59,6,17,5,22,2022/11/05 10:59:00 PM
2022/11/05,22:53,36,7,2,9,2022/11/05 10:53:00 PM
2022/11/05,22:50,2,2,0,2,2022/11/05 10:50:00 PM
2022/11/05,23:01,6,27,18,45,2022/11/05 11:01:00 PM
2022/11/05,23:04,72,5,0,5,2022/11/05 11:04:00 PM
2022/11/05,23:03,66,13,4,17,2022/11/05 11:03:00 PM
2022/11/05,23:03,14,3,2,5,2022/11/05 11:03:00 PM
2022/11/05,22:54,35,37,23,60,2022/11/05 10:54:00 PM
2022/11/05,22:53,30,13,5,18,2022/11/05 10:53:00 PM
2022/11/05,23:01,66,8,8,16,2022/11/05 11:01:00 PM
2022/11/05,22:45,20,0,2,2,2022/11/05 10:45:00 PM
2022/11/05,22:49,50,3,2,5,2022/11/05 10:49:00 PM
2022/11/05,22:56,65,5,11,16,2022/11/05 10:56:00 PM
2022/11/05,22:57,29,53,4,57,2022/11/05 10:57:00 PM
2022/11/05,23:01,84,5,3,8,2022/11/05 11:01:00 PM
2022/11/05,22:56,19,6,1,7,2022/11/05 10:56:00 PM
2022/11/05,22:49,12,6,1,7,2022/11/05 10:49:00 PM
2022/11/05,22:52,71,0,2,2,2022/11/05 10:52:00 PM
2022/11/05,23:04,76,1,0,1,2022/11/05 11:04:00 PM
2022/11/05,22:47,36,3,2,5,2022/11/05 10:47:00 PM
2022/11/05,22:51,14,2,2,4,2022/11/05 10:51:00 PM
2022/11/05,22:56,40,0,2,2,2022/11/05 10:56:00 PM
2022/11/05,22:50,40,7,2,9,2022/11/05 10:50:00 PM
2022/11/05,23:00,63,2,5,7,2022/11/05 11:00:00 PM
2022/11/05,22:51,30,4,19,23,2022/11/05 10:51:00 PM
2022/11/05,23:03,84,9,10,19,2022/11/05 11:03:00 PM
2022/11/05,22:59,48,1,0,1,2022/11/05 10:59:00 PM
2022/11/05,22:52,41,36,16,52,2022/11/05 10:52:00 PM
2022/11/05,22:59,20,6,2,8,2022/11/05 10:59:00 PM
2022/11/05,22:58,69,0,1,1,2022/11/05 10:58:00 PM
2022/11/05,22:56,35,35,9,44,2022/11/05 10:56:00 PM
2022/11/05,22:58,11,1,2,3,2022/11/05 10:58:00 PM
2022/11/05,22:52,49,1,1,2,2022/11/05 10:52:00 PM
2022/11/05,22:51,35,57,12,69,2022/11/05 10:51:00 PM
2022/11/05,22:50,20,12,7,19,2022/11/05 10:50:00 PM
2022/11/05,22:55,37,0,4,4,2022/11/05 10:55:00 PM
2022/11/05,22:53,72,3,17,20,2022/11/05 10:53:00 PM
2022/11/05,22:58,87,2,1,3,2022/11/05 10:58:00 PM
2022/11/05,22:55,3,11,1,12,2022/11/05 10:55:00 PM
2022/11/05,22:56,50,3,0,3,2022/11/05 10:56:00 PM
2022/11/05,22:59,36,2,8,10,2022/11/05 10:59:00 PM
2022/11/05,22:49,67,4,1,5,2022/11/05 10:49:00 PM
2022/11/05,23:00,79,12,14,26,2022/11/05 11:00:00 PM
2022/11/05,22:59,72,6,7,13,2022/11/05 10:59:00 PM
2022/11/05,23:03,72,6,6,12,2022/11/05 11:03:00 PM
2022/11/05,23:03,35,50,10,60,2022/11/05 11:03:00 PM
2022/11/05,22:54,29,95,7,102,2022/11/05 10:54:00 PM
2022/11/05,22:44,36,1,10,11,2022/11/05 10:44:00 PM
2022/11/05,22:54,14,7,0,7,2022/11/05 10:54:00 PM
2022/11/05,22:58,27,0,1,1,2022/11/05 10:58:00 PM
2022/11/05,22:54,51,0,1,1,2022/11/05 10:54:00 PM
2022/11/05,22:50,66,7,13,20,2022/11/05 10:50:00 PM
2022/11/05,22:59,56,0,3,3,2022/11/05 10:59:00 PM
2022/11/05,22:53,2,12,1,13,2022/11/05 10:53:00 PM
2022/11/05,22:47,23,0,1,1,2022/11/05 10:47:00 PM
2022/11/05,22:53,49,1,2,3,2022/11/05 10:53:00 PM
2022/11/05,22:59,1,8,11,19,2022/11/05 10:59:00 PM
2022/11/05,22:53,66,16,17,33,2022/11/05 10:53:00 PM
2022/11/05,22:50,59,6,0,6,2022/11/05 10:50:00 PM
2022/11/05,23:04,35,34,30,64,2022/11/05 11:04:00 PM
2022/11/05,22:57,54,0,1,1,2022/11/05 10:57:00 PM
2022/11/05,22:54,84,7,11,18,2022/11/05 10:54:00 PM
2022/11/05,22:50,5,12,13,25,2022/11/05 10:50:00 PM
2022/11/05,22:52,9,2,0,2,2022/11/05 10:52:00 PM
2022/11/05,23:03,71,1,0,1,2022/11/05 11:03:00 PM
2022/11/05,23:02,35,36,19,55,2022/11/05 11:02:00 PM
2022/11/05,22:57,67,1,3,4,2022/11/05 10:57:00 PM
2022/11/05,22:58,61,3,0,3,2022/11/05 10:58:00 PM
2022/11/05,22:49,48,3,2,5,2022/11/05 10:49:00 PM
2022/11/05,22:49,54,2,1,3,2022/11/05 10:49:00 PM
2022/11/05,22:59,65,3,3,6,2022/11/05 10:59:00 PM
2022/11/05,23:02,6,25,11,36,2022/11/05 11:02:00 PM
2022/11/05,22:59,44,9,0,9,2022/11/05 10:59:00 PM
2022/11/05,22:56,5,10,14,24,2022/11/05 10:56:00 PM
2022/11/05,23:00,1,2,7,9,2022/11/05 11:00:00 PM
2022/11/05,22:57,35,55,25,80,2022/11/05 10:57:00 PM
2022/11/05,22:58,54,0,1,1,2022/11/05 10:58:00 PM
2022/11/05,22:52,59,1,1,2,2022/11/05 10:52:00 PM
2022/11/05,22:50,76,2,0,2,2022/11/05 10:50:00 PM
2022/11/05,22:52,1,7,7,14,2022/11/05 10:52:00 PM
2022/11/05,23:02,39,0,1,1,2022/11/05 11:02:00 PM
2022/11/05,22:51,66,2,8,10,2022/11/05 10:51:00 PM
2022/11/05,22:47,40,13,1,14,2022/11/05 10:47:00 PM
2022/11/05,22:58,41,42,8,50,2022/11/05 10:58:00 PM
2022/11/05,22:56,12,1,0,1,2022/11/05 10:56:00 PM
2022/11/05,22:53,27,0,2,2,2022/11/05 10:53:00 PM
2022/11/05,22:59,79,11,6,17,2022/11/05 10:59:00 PM
2022/11/05,22:54,39,1,0,1,2022/11/05 10:54:00 PM
2022/11/05,22:55,79,5,10,15,2022/11/05 10:55:00 PM
2022/11/05,22:53,6,10,7,17,2022/11/05 10:53:00 PM
2022/11/05,22:54,58,1,9,10,2022/11/05 10:54:00 PM
2022/11/05,22:52,45,6,6,12,2022/11/05 10:52:00 PM
2022/11/05,22:58,35,55,10,65,2022/11/05 10:58:00 PM
2022/11/05,22:58,14,18,0,18,2022/11/05 10:58:00 PM
2022/11/05,23:02,84,18,21,39,2022/11/05 11:02:00 PM
2022/11/05,22:57,2,5,0,5,2022/11/05 10:57:00 PM
2022/11/05,22:52,37,2,8,10,2022/11/05 10:52:00 PM
2022/11/05,22:49,51,2,0,2,2022/11/05 10:49:00 PM
2022/11/05,22:52,3,13,22,35,2022/11/05 10:52:00 PM
2022/11/05,22:44,23,0,3,3,2022/11/05 10:44:00 PM
2022/11/05,23:02,12,0,4,4,2022/11/05 11:02:00 PM
2022/11/05,23:01,72,10,11,21,2022/11/05 11:01:00 PM
2022/11/05,22:46,31,5,12,17,2022/11/05 10:46:00 PM
2022/11/05,23:03,67,3,2,5,2022/11/05 11:03:00 PM
2022/11/05,22:52,48,3,0,3,2022/11/05 10:52:00 PM
2022/11/05,22:56,20,4,9,13,2022/11/05 10:56:00 PM
2022/11/05,22:50,24,10,1,11,2022/11/05 10:50:00 PM
2022/11/05,22:43,44,1,1,2,2022/11/05 10:43:00 PM
2022/11/05,22:59,68,0,1,1,2022/11/05 10:59:00 PM
2022/11/05,22:51,18,1,1,2,2022/11/05 10:51:00 PM
2022/11/05,23:00,45,5,14,19,2022/11/05 11:00:00 PM
2022/11/05,22:58,70,0,1,1,2022/11/05 10:58:00 PM
2022/11/05,23:01,39,1,0,1,2022/11/05 11:01:00 PM
2022/11/05,22:54,47,16,6,22,2022/11/05 10:54:00 PM
2022/11/05,22:49,40,2,0,2,2022/11/05 10:49:00 PM
2022/11/05,22:54,70,4,2,6,2022/11/05 10:54:00 PM
2022/11/05,22:45,36,1,0,1,2022/11/05 10:45:00 PM
2022/11/05,22:52,2,2,5,7,2022/11/05 10:52:00 PM
2022/11/05,23:02,30,5,1,6,2022/11/05 11:02:00 PM
2022/11/05,23:01,9,2,0,2,2022/11/05 11:01:00 PM
2022/11/05,22:52,14,14,7,21,2022/11/05 10:52:00 PM
2022/11/05,22:56,43,1,1,2,2022/11/05 10:56:00 PM
2022/11/05,23:02,2,2,2,4,2022/11/05 11:02:00 PM
2022/11/05,23:01,79,7,2,9,2022/11/05 11:01:00 PM
2022/11/05,22:56,84,7,22,29,2022/11/05 10:56:00 PM
2022/11/05,22:45,5,5,14,19,2022/11/05 10:45:00 PM
2022/11/05,22:51,5,4,12,16,2022/11/05 10:51:00 PM
2022/11/05,22:50,42,1,2,3,2022/11/05 10:50:00 PM
2022/11/05,22:49,47,6,7,13,2022/11/05 10:49:00 PM
2022/11/05,22:50,23,4,0,4,2022/11/05 10:50:00 PM
2022/11/05,22:59,5,19,7,26,2022/11/05 10:59:00 PM
2022/11/05,22:48,5,7,18,25,2022/11/05 10:48:00 PM
2022/11/05,22:57,57,0,1,1,2022/11/05 10:57:00 PM
2022/11/05,22:53,40,3,9,12,2022/11/05 10:53:00 PM
2022/11/05,22:51,86,0,2,2,2022/11/05 10:51:00 PM
2022/11/05,22:56,77,1,1,2,2022/11/05 10:56:00 PM
2022/11/05,22:57,65,5,8,13,2022/11/05 10:57:00 PM
2022/11/05,22:52,58,13,4,17,2022/11/05 10:52:00 PM
2022/11/05,23:03,30,6,10,16,2022/11/05 11:03:00 PM
2022/11/05,22:56,3,18,11,29,2022/11/05 10:56:00 PM
2022/11/05,23:03,3,18,27,45,2022/11/05 11:03:00 PM
2022/11/05,22:53,35,59,17,76,2022/11/05 10:53:00 PM
2022/11/05,22:58,20,4,5,9,2022/11/05 10:58:00 PM
2022/11/05,22:56,72,1,23,24,2022/11/05 10:56:00 PM
2022/11/05,22:51,41,7,36,43,2022/11/05 10:51:00 PM
2022/11/05,22:53,67,4,4,8,2022/11/05 10:53:00 PM
2022/11/05,22:53,3,11,25,36,2022/11/05 10:53:00 PM
2022/11/05,22:51,46,1,0,1,2022/11/05 10:51:00 PM
2022/11/05,22:54,71,0,1,1,2022/11/05 10:54:00 PM
2022/11/05,22:53,46,1,0,1,2022/11/05 10:53:00 PM
2022/11/05,22:59,24,8,9,17,2022/11/05 10:59:00 PM
2022/11/05,22:58,45,9,8,17,2022/11/05 10:58:00 PM
2022/11/05,22:57,4,10,8,18,2022/11/05 10:57:00 PM
2022/11/05,22:58,50,1,0,1,2022/11/05 10:58:00 PM
2022/11/05,23:03,41,12,20,32,2022/11/05 11:03:00 PM
2022/11/05,23:03,59,11,0,11,2022/11/05 11:03:00 PM
2022/11/05,22:40,23,3,0,3,2022/11/05 10:40:00 PM
2022/11/05,23:01,58,5,9,14,2022/11/05 11:01:00 PM
2022/11/05,22:52,54,3,0,3,2022/11/05 10:52:00 PM
2022/11/05,22:50,86,2,0,2,2022/11/05 10:50:00 PM
2022/11/05,22:59,47,13,6,19,2022/11/05 10:59:00 PM
2022/11/05,22:54,61,1,2,3,2022/11/05 10:54:00 PM
2022/11/05,22:54,49,1,0,1,2022/11/05 10:54:00 PM
2022/11/05,23:01,24,0,4,4,2022/11/05 11:01:00 PM
2022/11/05,22:54,50,3,5,8,2022/11/05 10:54:00 PM
2022/11/05,22:49,41,39,17,56,2022/11/05 10:49:00 PM
2022/11/05,23:02,51,1,0,1,2022/11/05 11:02:00 PM
2022/11/05,22:49,31,14,8,22,2022/11/05 10:49:00 PM
2022/11/05,22:47,57,2,0,2,2022/11/05 10:47:00 PM
2022/11/05,22:55,69,1,0,1,2022/11/05 10:55:00 PM
2022/11/05,22:58,85,1,0,1,2022/11/05 10:58:00 PM
2022/11/05,22:53,41,36,12,48,2022/11/05 10:53:00 PM
2022/11/05,22:57,23,3,0,3,2022/11/05 10:57:00 PM
2022/11/05,22:57,18,0,1,1,2022/11/05 10:57:00 PM
2022/11/05,22:53,39,1,2,3,2022/11/05 10:53:00 PM
2022/11/05,23:03,62,0,1,1,2022/11/05 11:03:00 PM
2022/11/05,23:03,28,5,14,19,2022/11/05 11:03:00 PM
2022/11/05,22:54,59,2,1,3,2022/11/05 10:54:00 PM
2022/11/05,23:01,50,0,2,2,2022/11/05 11:01:00 PM
2022/11/05,23:03,6,12,2,14,2022/11/05 11:03:00 PM
2022/11/05,22:49,3,18,10,28,2022/11/05 10:49:00 PM
2022/11/05,22:54,65,9,6,15,2022/11/05 10:54:00 PM
2022/11/05,22:56,70,1,4,5,2022/11/05 10:56:00 PM
2022/11/05,22:50,18,0,1,1,2022/11/05 10:50:00 PM
2022/11/05,23:00,29,58,18,76,2022/11/05 11:00:00 PM
2022/11/05,22:53,31,10,9,19,2022/11/05 10:53:00 PM
2022/11/05,22:55,41,30,19,49,2022/11/05 10:55:00 PM
2022/11/05,22:53,12,0,2,2,2022/11/05 10:53:00 PM
2022/11/05,22:50,41,58,20,78,2022/11/05 10:50:00 PM
2022/11/05,22:41,23,1,1,2,2022/11/05 10:41:00 PM
2022/11/05,23:00,62,0,2,2,2022/11/05 11:00:00 PM
2022/11/05,22:57,14,10,6,16,2022/11/05 10:57:00 PM
2022/11/05,22:50,70,3,0,3,2022/11/05 10:50:00 PM
2022/11/05,22:51,20,23,2,25,2022/11/05 10:51:00 PM
2022/11/05,22:51,6,16,13,29,2022/11/05 10:51:00 PM
2022/11/05,23:01,70,1,2,3,2022/11/05 11:01:00 PM
2022/11/05,22:45,57,1,0,1,2022/11/05 10:45:00 PM
2022/11/05,22:51,77,2,2,4,2022/11/05 10:51:00 PM
2022/11/05,22:55,40,1,1,2,2022/11/05 10:55:00 PM
2022/11/05,23:01,69,0,1,1,2022/11/05 11:01:00 PM
2022/11/05,22:53,70,0,2,2,2022/11/05 10:53:00 PM
2022/11/05,23:00,14,6,4,10,2022/11/05 11:00:00 PM
2022/11/05,22:58,72,4,9,13,2022/11/05 10:58:00 PM
2022/11/05,22:57,79,11,12,23,2022/11/05 10:57:00 PM
2022/11/05,23:02,28,5,22,27,2022/11/05 11:02:00 PM
2022/11/05,22:53,20,11,3,14,2022/11/05 10:53:00 PM
2022/11/05,22:56,41,34,13,47,2022/11/05 10:56:00 PM
2022/11/05,22:50,37,12,6,18,2022/11/05 10:50:00 PM
2022/11/05,22:52,62,0,4,4,2022/11/05 10:52:00 PM
2022/11/05,22:51,37,2,9,11,2022/11/05 10:51:00 PM
2022/11/05,22:59,39,0,2,2,2022/11/05 10:59:00 PM
2022/11/05,22:50,65,1,4,5,2022/11/05 10:50:00 PM
2022/11/05,22:57,12,4,5,9,2022/11/05 10:57:00 PM
2022/11/05,22:49,68,2,3,5,2022/11/05 10:49:00 PM
2022/11/05,23:01,68,1,1,2,2022/11/05 11:01:00 PM
2022/11/05,22:49,36,3,1,4,2022/11/05 10:49:00 PM
2022/11/05,23:04,66,6,0,6,2022/11/05 11:04:00 PM
2022/11/05,22:56,66,4,6,10,2022/11/05 10:56:00 PM
2022/11/05,22:59,29,95,6,101,2022/11/05 10:59:00 PM
2022/11/05,22:51,1,9,5,14,2022/11/05 10:51:00 PM
2022/11/05,22:59,14,9,2,11,2022/11/05 10:59:00 PM
2022/11/05,23:01,48,6,0,6,2022/11/05 11:01:00 PM
2022/11/05,22:50,69,0,3,3,2022/11/05 10:50:00 PM
2022/11/05,22:55,12,3,2,5,2022/11/05 10:55:00 PM
2022/11/05,22:57,5,5,16,21,2022/11/05 10:57:00 PM
2022/11/05,22:52,50,4,0,4,2022/11/05 10:52:00 PM
2022/11/05,22:56,85,0,1,1,2022/11/05 10:56:00 PM
2022/11/05,22:51,70,0,3,3,2022/11/05 10:51:00 PM
2022/11/05,22:51,4,20,8,28,2022/11/05 10:51:00 PM
2022/11/05,22:47,5,13,16,29,2022/11/05 10:47:00 PM
2022/11/05,22:49,58,12,7,19,2022/11/05 10:49:00 PM
2022/11/05,22:58,67,0,6,6,2022/11/05 10:58:00 PM
2022/11/05,22:49,46,2,0,2,2022/11/05 10:49:00 PM
2022/11/05,22:54,66,11,4,15,2022/11/05 10:54:00 PM
2022/11/05,23:01,4,21,3,24,2022/11/05 11:01:00 PM
2022/11/05,23:01,20,11,6,17,2022/11/05 11:01:00 PM
2022/11/05,23:02,63,3,4,7,2022/11/05 11:02:00 PM
2022/11/05,22:52,67,6,1,7,2022/11/05 10:52:00 PM
2022/11/05,23:01,49,1,0,1,2022/11/05 11:01:00 PM
2022/11/05,22:48,61,0,2,2,2022/11/05 10:48:00 PM
2022/11/05,22:52,5,11,12,23,2022/11/05 10:52:00 PM
2022/11/05,22:47,19,9,13,22,2022/11/05 10:47:00 PM
2022/11/05,22:56,29,76,10,86,2022/11/05 10:56:00 PM
2022/11/05,23:00,47,9,11,20,2022/11/05 11:00:00 PM
2022/11/05,23:02,66,8,4,12,2022/11/05 11:02:00 PM
2022/11/05,23:01,59,8,1,9,2022/11/05 11:01:00 PM
2022/11/05,23:02,69,1,5,6,2022/11/05 11:02:00 PM
2022/11/05,22:55,63,3,7,10,2022/11/05 10:55:00 PM
2022/11/05,22:51,67,6,1,7,2022/11/05 10:51:00 PM
2022/11/05,22:50,4,8,24,32,2022/11/05 10:50:00 PM
2022/11/05,22:56,59,4,2,6,2022/11/05 10:56:00 PM
2022/11/05,22:59,86,1,0,1,2022/11/05 10:59:00 PM
2022/11/05,23:04,62,3,0,3,2022/11/05 11:04:00 PM
2022/11/05,23:01,36,1,5,6,2022/11/05 11:01:00 PM
2022/11/05,23:04,29,43,1,44,2022/11/05 11:04:00 PM
2022/11/05,22:55,59,2,0,2,2022/11/05 10:55:00 PM
2022/11/05,22:53,65,3,8,11,2022/11/05 10:53:00 PM
2022/11/05,22:58,66,9,4,13,2022/11/05 10:58:00 PM
2022/11/05,22:47,61,1,3,4,2022/11/05 10:47:00 PM
2022/11/05,23:00,30,10,7,17,2022/11/05 11:00:00 PM
2022/11/05,22:59,49,1,1,2,2022/11/05 10:59:00 PM
2022/11/05,22:56,67,5,3,8,2022/11/05 10:56:00 PM
2022/11/05,22:53,69,1,0,1,2022/11/05 10:53:00 PM
2022/11/05,22:58,6,13,6,19,2022/11/05 10:58:00 PM
2022/11/05,23:00,68,1,1,2,2022/11/05 11:00:00 PM
2022/11/05,22:52,84,15,13,28,2022/11/05 10:52:00 PM
2022/11/05,23:03,77,1,2,3,2022/11/05 11:03:00 PM
2022/11/05,23:01,65,3,27,30,2022/11/05 11:01:00 PM
2022/11/05,23:00,56,0,6,6,2022/11/05 11:00:00 PM
2022/11/05,22:50,79,26,7,33,2022/11/05 10:50:00 PM
2022/11/05,22:59,40,2,3,5,2022/11/05 10:59:00 PM
2022/11/05,22:52,28,3,44,47,2022/11/05 10:52:00 PM
2022/11/05,22:56,48,3,0,3,2022/11/05 10:56:00 PM
2022/11/05,22:50,29,86,11,97,2022/11/05 10:50:00 PM
2022/11/05,22:53,47,5,2,7,2022/11/05 10:53:00 PM
2022/11/05,22:55,1,6,4,10,2022/11/05 10:55:00 PM
2022/11/05,23:02,45,3,6,9,2022/11/05 11:02:00 PM
2022/11/05,22:51,27,1,0,1,2022/11/05 10:51:00 PM
2022/11/05,22:53,59,2,1,3,2022/11/05 10:53:00 PM
2022/11/05,22:51,72,7,16,23,2022/11/05 10:51:00 PM
2022/11/05,22:56,54,4,2,6,2022/11/05 10:56:00 PM
2022/11/05,22:53,42,2,0,2,2022/11/05 10:53:00 PM
2022/11/05,22:56,21,5,8,13,2022/11/05 10:56:00 PM
2022/11/05,22:57,45,17,13,30,2022/11/05 10:57:00 PM
2022/11/05,23:02,65,3,10,13,2022/11/05 11:02:00 PM
2022/11/05,22:53,45,3,10,13,2022/11/05 10:53:00 PM
2022/11/05,22:57,46,4,0,4,2022/11/05 10:57:00 PM
2022/11/05,22:55,70,3,1,4,2022/11/05 10:55:00 PM
2022/11/05,22:48,30,4,2,6,2022/11/05 10:48:00 PM
2022/11/05,23:02,49,0,1,1,2022/11/05 11:02:00 PM
2022/11/05,22:48,37,4,4,8,2022/11/05 10:48:00 PM
2022/11/05,22:53,58,9,3,12,2022/11/05 10:53:00 PM
2022/11/05,22:54,77,0,3,3,2022/11/05 10:54:00 PM
2022/11/05,22:55,24,3,0,3,2022/11/05 10:55:00 PM
2022/11/05,22:52,27,0,2,2,2022/11/05 10:52:00 PM
2022/11/05,22:54,3,36,13,49,2022/11/05 10:54:00 PM
2022/11/05,22:43,36,0,1,1,2022/11/05 10:43:00 PM
2022/11/05,22:53,8,1,0,1,2022/11/05 10:53:00 PM
2022/11/05,22:58,56,7,0,7,2022/11/05 10:58:00 PM
2022/11/05,22:58,58,4,1,5,2022/11/05 10:58:00 PM
2022/11/05,22:54,54,3,0,3,2022/11/05 10:54:00 PM
2022/11/05,23:03,58,9,7,16,2022/11/05 11:03:00 PM
2022/11/05,22:56,45,13,10,23,2022/11/05 10:56:00 PM
2022/11/05,22:56,8,0,1,1,2022/11/05 10:56:00 PM
2022/11/05,22:49,19,10,1,11,2022/11/05 10:49:00 PM
2022/11/05,22:57,63,4,13,17,2022/11/05 10:57:00 PM
2022/11/05,22:56,79,13,12,25,2022/11/05 10:56:00 PM
2022/11/05,22:58,39,1,0,1,2022/11/05 10:58:00 PM
2022/11/05,22:54,21,15,11,26,2022/11/05 10:54:00 PM
2022/11/05,23:00,24,2,1,3,2022/11/05 11:00:00 PM
2022/11/05,22:12,5,9,10,19,2022/11/05 10:12:00 PM
2022/11/05,22:17,14,10,3,13,2022/11/05 10:17:00 PM
2022/11/05,22:08,59,4,15,19,2022/11/05 10:08:00 PM
2022/11/05,22:08,2,1,2,3,2022/11/05 10:08:00 PM
2022/11/05,22:19,77,3,1,4,2022/11/05 10:19:00 PM
2022/11/05,22:11,87,1,0,1,2022/11/05 10:11:00 PM
2022/11/05,22:12,37,2,6,8,2022/11/05 10:12:00 PM
2022/11/05,22:14,56,9,8,17,2022/11/05 10:14:00 PM
2022/11/05,22:14,58,4,4,8,2022/11/05 10:14:00 PM
2022/11/05,22:13,51,0,12,12,2022/11/05 10:13:00 PM
2022/11/05,22:18,10,0,1,1,2022/11/05 10:18:00 PM
2022/11/05,22:15,49,0,3,3,2022/11/05 10:15:00 PM
2022/11/05,22:17,11,8,1,9,2022/11/05 10:17:00 PM
2022/11/05,22:12,72,5,13,18,2022/11/05 10:12:00 PM
2022/11/05,22:11,35,20,10,30,2022/11/05 10:11:00 PM
2022/11/05,22:13,40,3,3,6,2022/11/05 10:13:00 PM
2022/11/05,22:14,35,42,15,57,2022/11/05 10:14:00 PM
2022/11/05,22:08,41,20,22,42,2022/11/05 10:08:00 PM
2022/11/05,22:10,40,4,0,4,2022/11/05 10:10:00 PM
2022/11/05,22:11,24,1,1,2,2022/11/05 10:11:00 PM
2022/11/05,22:17,50,0,3,3,2022/11/05 10:17:00 PM
2022/11/05,22:12,61,3,1,4,2022/11/05 10:12:00 PM
2022/11/05,22:16,62,1,2,3,2022/11/05 10:16:00 PM
2022/11/05,22:12,28,0,52,52,2022/11/05 10:12:00 PM
2022/11/05,22:08,47,9,14,23,2022/11/05 10:08:00 PM
2022/11/05,22:13,2,2,1,3,2022/11/05 10:13:00 PM
2022/11/05,22:14,12,4,4,8,2022/11/05 10:14:00 PM
2022/11/05,22:11,47,5,14,19,2022/11/05 10:11:00 PM
2022/11/05,22:11,56,1,1,2,2022/11/05 10:11:00 PM
2022/11/05,22:08,14,6,1,7,2022/11/05 10:08:00 PM
2022/11/05,22:17,9,1,2,3,2022/11/05 10:17:00 PM
2022/11/05,22:08,18,3,2,5,2022/11/05 10:08:00 PM
2022/11/05,22:16,24,1,3,4,2022/11/05 10:16:00 PM
2022/11/05,22:10,56,10,0,10,2022/11/05 10:10:00 PM
2022/11/05,22:09,62,1,3,4,2022/11/05 10:09:00 PM
2022/11/05,22:09,31,7,4,11,2022/11/05 10:09:00 PM
2022/11/05,22:14,41,25,12,37,2022/11/05 10:14:00 PM
2022/11/05,22:18,49,3,0,3,2022/11/05 10:18:00 PM
2022/11/05,22:09,66,16,8,24,2022/11/05 10:09:00 PM
2022/11/05,22:12,29,113,0,113,2022/11/05 10:12:00 PM
2022/11/05,22:10,24,5,0,5,2022/11/05 10:10:00 PM
2022/11/05,22:17,72,5,14,19,2022/11/05 10:17:00 PM
2022/11/05,22:16,63,19,2,21,2022/11/05 10:16:00 PM
2022/11/05,22:17,85,0,1,1,2022/11/05 10:17:00 PM
2022/11/05,22:10,39,1,2,3,2022/11/05 10:10:00 PM
2022/11/05,22:13,3,15,9,24,2022/11/05 10:13:00 PM
2022/11/05,22:15,54,0,1,1,2022/11/05 10:15:00 PM
2022/11/05,22:14,62,2,1,3,2022/11/05 10:14:00 PM
2022/11/05,22:11,58,2,1,3,2022/11/05 10:11:00 PM
2022/11/05,22:16,12,0,1,1,2022/11/05 10:16:00 PM
2022/11/05,22:14,6,14,13,27,2022/11/05 10:14:00 PM
2022/11/05,22:09,68,2,4,6,2022/11/05 10:09:00 PM
2022/11/05,22:11,51,0,1,1,2022/11/05 10:11:00 PM
2022/11/05,22:15,18,0,1,1,2022/11/05 10:15:00 PM
2022/11/05,22:14,2,4,1,5,2022/11/05 10:14:00 PM
2022/11/05,22:09,10,0,2,2,2022/11/05 10:09:00 PM
2022/11/05,22:17,4,15,12,27,2022/11/05 10:17:00 PM
2022/11/05,22:13,41,18,7,25,2022/11/05 10:13:00 PM
2022/11/05,22:13,29,53,10,63,2022/11/05 10:13:00 PM
2022/11/05,22:12,6,23,4,27,2022/11/05 10:12:00 PM
2022/11/05,22:19,72,2,11,13,2022/11/05 10:19:00 PM
2022/11/05,22:17,2,1,7,8,2022/11/05 10:17:00 PM
2022/11/05,22:17,45,2,7,9,2022/11/05 10:17:00 PM
2022/11/05,22:08,67,4,3,7,2022/11/05 10:08:00 PM
2022/11/05,22:14,29,51,9,60,2022/11/05 10:14:00 PM
2022/11/05,22:14,37,7,7,14,2022/11/05 10:14:00 PM
2022/11/05,22:18,14,6,7,13,2022/11/05 10:18:00 PM
2022/11/05,22:17,58,0,3,3,2022/11/05 10:17:00 PM
2022/11/05,22:10,66,7,2,9,2022/11/05 10:10:00 PM
2022/11/05,22:14,28,2,65,67,2022/11/05 10:14:00 PM
2022/11/05,22:11,20,5,9,14,2022/11/05 10:11:00 PM
2022/11/05,22:15,47,6,6,12,2022/11/05 10:15:00 PM
2022/11/05,22:16,72,3,1,4,2022/11/05 10:16:00 PM
2022/11/05,22:15,9,0,1,1,2022/11/05 10:15:00 PM
2022/11/05,22:08,37,3,8,11,2022/11/05 10:08:00 PM
2022/11/05,22:17,28,0,24,24,2022/11/05 10:17:00 PM
2022/11/05,22:17,84,20,9,29,2022/11/05 10:17:00 PM
2022/11/05,22:18,28,0,8,8,2022/11/05 10:18:00 PM
2022/11/05,22:13,84,6,15,21,2022/11/05 10:13:00 PM
2022/11/05,22:12,58,2,5,7,2022/11/05 10:12:00 PM
2022/11/05,22:12,14,6,3,9,2022/11/05 10:12:00 PM
2022/11/05,22:16,66,17,4,21,2022/11/05 10:16:00 PM
2022/11/05,22:11,21,0,8,8,2022/11/05 10:11:00 PM
2022/11/05,22:13,50,2,4,6,2022/11/05 10:13:00 PM
2022/11/05,22:11,9,0,2,2,2022/11/05 10:11:00 PM
2022/11/05,22:11,84,15,16,31,2022/11/05 10:11:00 PM
2022/11/05,22:12,20,13,2,15,2022/11/05 10:12:00 PM
2022/11/05,22:14,21,3,15,18,2022/11/05 10:14:00 PM
2022/11/05,22:17,49,0,2,2,2022/11/05 10:17:00 PM
2022/11/05,22:08,12,2,8,10,2022/11/05 10:08:00 PM
2022/11/05,22:09,21,4,14,18,2022/11/05 10:09:00 PM
2022/11/05,22:10,8,4,1,5,2022/11/05 10:10:00 PM
2022/11/05,22:12,48,1,0,1,2022/11/05 10:12:00 PM
2022/11/05,22:11,70,0,3,3,2022/11/05 10:11:00 PM
2022/11/05,22:08,63,12,4,16,2022/11/05 10:08:00 PM
2022/11/05,22:11,77,1,8,9,2022/11/05 10:11:00 PM
2022/11/05,22:11,5,9,12,21,2022/11/05 10:11:00 PM
2022/11/05,22:09,20,19,0,19,2022/11/05 10:09:00 PM
2022/11/05,22:11,63,4,4,8,2022/11/05 10:11:00 PM
2022/11/05,22:09,35,33,25,58,2022/11/05 10:09:00 PM
2022/11/05,22:08,87,2,1,3,2022/11/05 10:08:00 PM
2022/11/05,22:18,66,11,9,20,2022/11/05 10:18:00 PM
2022/11/05,22:13,59,8,7,15,2022/11/05 10:13:00 PM
2022/11/05,22:12,41,8,13,21,2022/11/05 10:12:00 PM
2022/11/05,22:09,29,24,0,24,2022/11/05 10:09:00 PM
2022/11/05,22:10,9,3,0,3,2022/11/05 10:10:00 PM
2022/11/05,22:10,3,21,9,30,2022/11/05 10:10:00 PM
2022/11/05,22:14,50,4,2,6,2022/11/05 10:14:00 PM
2022/11/05,22:13,58,11,13,24,2022/11/05 10:13:00 PM
2022/11/05,22:10,18,0,2,2,2022/11/05 10:10:00 PM
2022/11/05,22:11,76,1,0,1,2022/11/05 10:11:00 PM
2022/11/05,22:12,69,1,1,2,2022/11/05 10:12:00 PM
2022/11/05,22:10,72,4,4,8,2022/11/05 10:10:00 PM
2022/11/05,22:17,20,5,51,56,2022/11/05 10:17:00 PM
2022/11/05,22:13,72,1,7,8,2022/11/05 10:13:00 PM
2022/11/05,22:18,9,1,1,2,2022/11/05 10:18:00 PM
2022/11/05,22:12,79,2,5,7,2022/11/05 10:12:00 PM
2022/11/05,22:13,47,5,15,20,2022/11/05 10:13:00 PM
2022/11/05,22:08,27,0,2,2,2022/11/05 10:08:00 PM
2022/11/05,22:15,41,11,21,32,2022/11/05 10:15:00 PM
2022/11/05,22:11,6,10,8,18,2022/11/05 10:11:00 PM
2022/11/05,22:10,10,0,2,2,2022/11/05 10:10:00 PM
2022/11/05,22:10,5,13,13,26,2022/11/05 10:10:00 PM
2022/11/05,22:09,49,5,1,6,2022/11/05 10:09:00 PM
2022/11/05,22:16,11,0,1,1,2022/11/05 10:16:00 PM
2022/11/05,22:14,54,1,10,11,2022/11/05 10:14:00 PM
2022/11/05,22:13,54,0,2,2,2022/11/05 10:13:00 PM
2022/11/05,22:13,5,12,8,20,2022/11/05 10:13:00 PM
2022/11/05,22:15,70,1,7,8,2022/11/05 10:15:00 PM
2022/11/05,22:16,41,22,9,31,2022/11/05 10:16:00 PM
2022/11/05,22:14,79,7,4,11,2022/11/05 10:14:00 PM
2022/11/05,22:15,28,4,40,44,2022/11/05 10:15:00 PM
2022/11/05,22:16,6,15,9,24,2022/11/05 10:16:00 PM
2022/11/05,22:11,31,3,5,8,2022/11/05 10:11:00 PM
2022/11/05,22:10,12,2,3,5,2022/11/05 10:10:00 PM
2022/11/05,22:12,21,14,18,32,2022/11/05 10:12:00 PM
2022/11/05,22:11,48,2,3,5,2022/11/05 10:11:00 PM
2022/11/05,22:18,70,0,2,2,2022/11/05 10:18:00 PM
2022/11/05,22:18,3,24,22,46,2022/11/05 10:18:00 PM
2022/11/05,22:16,28,3,55,58,2022/11/05 10:16:00 PM
2022/11/05,22:18,68,1,1,2,2022/11/05 10:18:00 PM
2022/11/05,22:11,4,21,9,30,2022/11/05 10:11:00 PM
2022/11/05,22:09,3,17,10,27,2022/11/05 10:09:00 PM
2022/11/05,22:18,2,6,3,9,2022/11/05 10:18:00 PM
2022/11/05,22:13,21,12,11,23,2022/11/05 10:13:00 PM
2022/11/05,22:08,42,0,2,2,2022/11/05 10:08:00 PM
2022/11/05,22:12,30,6,4,10,2022/11/05 10:12:00 PM
2022/11/05,22:10,19,12,6,18,2022/11/05 10:10:00 PM
2022/11/05,22:09,76,0,1,1,2022/11/05 10:09:00 PM
2022/11/05,22:11,66,7,5,12,2022/11/05 10:11:00 PM
2022/11/05,22:17,8,0,1,1,2022/11/05 10:17:00 PM
2022/11/05,22:16,70,1,0,1,2022/11/05 10:16:00 PM
2022/11/05,22:09,24,5,5,10,2022/11/05 10:09:00 PM
2022/11/05,22:11,85,0,1,1,2022/11/05 10:11:00 PM
2022/11/05,22:08,48,1,0,1,2022/11/05 10:08:00 PM
2022/11/05,22:14,3,2,20,22,2022/11/05 10:14:00 PM
2022/11/05,22:17,6,18,9,27,2022/11/05 10:17:00 PM
2022/11/05,22:17,59,1,3,4,2022/11/05 10:17:00 PM
2022/11/05,22:11,72,6,0,6,2022/11/05 10:11:00 PM
2022/11/05,22:18,1,6,6,12,2022/11/05 10:18:00 PM
2022/11/05,22:19,14,12,5,17,2022/11/05 10:19:00 PM
2022/11/05,22:09,61,3,0,3,2022/11/05 10:09:00 PM
2022/11/05,22:09,65,2,14,16,2022/11/05 10:09:00 PM
2022/11/05,22:12,10,0,1,1,2022/11/05 10:12:00 PM
2022/11/05,22:14,63,10,6,16,2022/11/05 10:14:00 PM
2022/11/05,22:16,35,33,24,57,2022/11/05 10:16:00 PM
2022/11/05,22:14,5,12,11,23,2022/11/05 10:14:00 PM
2022/11/05,22:09,45,6,4,10,2022/11/05 10:09:00 PM
2022/11/05,22:16,77,4,3,7,2022/11/05 10:16:00 PM
2022/11/05,22:19,39,0,1,1,2022/11/05 10:19:00 PM
2022/11/05,22:13,28,2,62,64,2022/11/05 10:13:00 PM
2022/11/05,22:16,29,57,7,64,2022/11/05 10:16:00 PM
2022/11/05,22:13,35,28,20,48,2022/11/05 10:13:00 PM
2022/11/05,22:09,40,4,0,4,2022/11/05 10:09:00 PM
2022/11/05,22:08,66,11,8,19,2022/11/05 10:08:00 PM
2022/11/05,22:16,1,3,1,4,2022/11/05 10:16:00 PM
2022/11/05,22:11,59,3,0,3,2022/11/05 10:11:00 PM
2022/11/05,22:15,24,0,2,2,2022/11/05 10:15:00 PM
2022/11/05,22:17,56,2,3,5,2022/11/05 10:17:00 PM
2022/11/05,22:10,28,2,63,65,2022/11/05 10:10:00 PM
2022/11/05,22:12,67,3,9,12,2022/11/05 10:12:00 PM
2022/11/05,22:15,14,10,8,18,2022/11/05 10:15:00 PM
2022/11/05,22:09,58,6,2,8,2022/11/05 10:09:00 PM
2022/11/05,22:18,6,16,12,28,2022/11/05 10:18:00 PM
2022/11/05,22:12,27,0,1,1,2022/11/05 10:12:00 PM
2022/11/05,22:14,1,3,4,7,2022/11/05 10:14:00 PM
2022/11/05,22:18,51,0,5,5,2022/11/05 10:18:00 PM
2022/11/05,22:08,79,20,12,32,2022/11/05 10:08:00 PM
2022/11/05,22:16,65,2,8,10,2022/11/05 10:16:00 PM
2022/11/05,22:09,71,0,1,1,2022/11/05 10:09:00 PM
2022/11/05,22:11,41,36,15,51,2022/11/05 10:11:00 PM
2022/11/05,22:18,12,2,1,3,2022/11/05 10:18:00 PM
2022/11/05,22:08,84,5,12,17,2022/11/05 10:08:00 PM
2022/11/05,22:14,66,10,12,22,2022/11/05 10:14:00 PM
2022/11/05,22:09,54,0,2,2,2022/11/05 10:09:00 PM
2022/11/05,22:08,1,9,5,14,2022/11/05 10:08:00 PM
2022/11/05,22:18,77,4,0,4,2022/11/05 10:18:00 PM
2022/11/05,22:15,45,3,7,10,2022/11/05 10:15:00 PM
2022/11/05,22:11,28,2,64,66,2022/11/05 10:11:00 PM
2022/11/05,22:17,12,3,0,3,2022/11/05 10:17:00 PM
2022/11/05,22:10,70,1,0,1,2022/11/05 10:10:00 PM
2022/11/05,22:08,31,1,14,15,2022/11/05 10:08:00 PM
2022/11/05,22:18,35,37,19,56,2022/11/05 10:18:00 PM
2022/11/05,22:18,84,15,7,22,2022/11/05 10:18:00 PM
2022/11/05,22:08,6,12,9,21,2022/11/05 10:08:00 PM
2022/11/05,22:16,67,6,7,13,2022/11/05 10:16:00 PM
2022/11/05,22:12,50,4,2,6,2022/11/05 10:12:00 PM
2022/11/05,22:14,67,12,0,12,2022/11/05 10:14:00 PM
2022/11/05,22:12,39,0,2,2,2022/11/05 10:12:00 PM
2022/11/05,22:11,11,4,0,4,2022/11/05 10:11:00 PM
2022/11/05,22:12,66,11,12,23,2022/11/05 10:12:00 PM
2022/11/05,22:11,3,17,13,30,2022/11/05 10:11:00 PM
2022/11/05,22:09,67,4,8,12,2022/11/05 10:09:00 PM
2022/11/05,22:15,3,16,2,18,2022/11/05 10:15:00 PM
2022/11/05,22:09,11,0,1,1,2022/11/05 10:09:00 PM
2022/11/05,22:10,59,3,2,5,2022/11/05 10:10:00 PM
2022/11/05,22:11,39,4,0,4,2022/11/05 10:11:00 PM
2022/11/05,22:11,14,8,1,9,2022/11/05 10:11:00 PM
2022/11/05,22:12,3,27,23,50,2022/11/05 10:12:00 PM
2022/11/05,22:18,4,6,2,8,2022/11/05 10:18:00 PM
2022/11/05,22:11,29,40,7,47,2022/11/05 10:11:00 PM
2022/11/05,22:09,79,6,1,7,2022/11/05 10:09:00 PM
2022/11/05,22:10,79,10,2,12,2022/11/05 10:10:00 PM
2022/11/05,22:12,4,8,8,16,2022/11/05 10:12:00 PM
2022/11/05,22:14,4,20,14,34,2022/11/05 10:14:00 PM
2022/11/05,22:11,79,5,3,8,2022/11/05 10:11:00 PM
2022/11/05,22:15,29,67,5,72,2022/11/05 10:15:00 PM
2022/11/05,22:09,36,8,2,10,2022/11/05 10:09:00 PM
2022/11/05,22:12,2,12,0,12,2022/11/05 10:12:00 PM
2022/11/05,22:09,48,1,0,1,2022/11/05 10:09:00 PM
2022/11/05,22:19,29,29,4,33,2022/11/05 10:19:00 PM
2022/11/05,22:10,36,0,1,1,2022/11/05 10:10:00 PM
2022/11/05,22:18,27,0,7,7,2022/11/05 10:18:00 PM
2022/11/05,22:13,6,21,5,26,2022/11/05 10:13:00 PM
2022/11/05,22:08,77,1,1,2,2022/11/05 10:08:00 PM
2022/11/05,22:16,51,2,1,3,2022/11/05 10:16:00 PM
2022/11/05,22:08,72,1,2,3,2022/11/05 10:08:00 PM
2022/11/05,22:11,50,15,0,15,2022/11/05 10:11:00 PM
2022/11/05,22:14,72,2,2,4,2022/11/05 10:14:00 PM
2022/11/05,22:11,37,0,12,12,2022/11/05 10:11:00 PM
2022/11/05,22:10,41,10,18,28,2022/11/05 10:10:00 PM
2022/11/05,22:09,12,1,6,7,2022/11/05 10:09:00 PM
2022/11/05,22:19,66,18,5,23,2022/11/05 10:19:00 PM
2022/11/05,22:15,65,2,10,12,2022/11/05 10:15:00 PM
2022/11/05,22:10,48,0,2,2,2022/11/05 10:10:00 PM
2022/11/05,22:10,68,0,7,7,2022/11/05 10:10:00 PM
2022/11/05,22:09,14,6,3,9,2022/11/05 10:09:00 PM
2022/11/05,22:09,8,1,0,1,2022/11/05 10:09:00 PM
2022/11/05,22:17,27,14,0,14,2022/11/05 10:17:00 PM
2022/11/05,22:10,58,2,3,5,2022/11/05 10:10:00 PM
2022/11/05,22:09,84,10,11,21,2022/11/05 10:09:00 PM
2022/11/05,22:18,8,0,1,1,2022/11/05 10:18:00 PM
2022/11/05,22:10,85,1,0,1,2022/11/05 10:10:00 PM
2022/11/05,22:15,62,0,3,3,2022/11/05 10:15:00 PM
2022/11/05,22:08,56,0,1,1,2022/11/05 10:08:00 PM
2022/11/05,22:15,56,2,3,5,2022/11/05 10:15:00 PM
2022/11/05,22:14,39,1,1,2,2022/11/05 10:14:00 PM
2022/11/05,22:16,47,8,1,9,2022/11/05 10:16:00 PM
2022/11/05,22:08,68,0,1,1,2022/11/05 10:08:00 PM
2022/11/05,22:16,68,0,3,3,2022/11/05 10:16:00 PM
2022/11/05,22:18,62,3,0,3,2022/11/05 10:18:00 PM
2022/11/05,22:15,42,2,0,2,2022/11/05 10:15:00 PM
2022/11/05,22:08,29,39,9,48,2022/11/05 10:08:00 PM
2022/11/05,22:08,65,0,6,6,2022/11/05 10:08:00 PM
2022/11/05,22:11,12,0,3,3,2022/11/05 10:11:00 PM
2022/11/05,22:13,63,5,33,38,2022/11/05 10:13:00 PM
2022/11/05,22:14,46,0,1,1,2022/11/05 10:14:00 PM
2022/11/05,22:16,2,1,7,8,2022/11/05 10:16:00 PM
2022/11/05,22:15,84,12,5,17,2022/11/05 10:15:00 PM
2022/11/05,22:17,35,38,27,65,2022/11/05 10:17:00 PM
2022/11/05,22:17,65,0,7,7,2022/11/05 10:17:00 PM
2022/11/05,22:10,1,2,1,3,2022/11/05 10:10:00 PM
2022/11/05,22:18,65,4,0,4,2022/11/05 10:18:00 PM
2022/11/05,22:15,6,8,6,14,2022/11/05 10:15:00 PM
2022/11/05,22:11,42,0,4,4,2022/11/05 10:11:00 PM
2022/11/05,22:09,59,4,4,8,2022/11/05 10:09:00 PM
2022/11/05,22:15,20,9,0,9,2022/11/05 10:15:00 PM
2022/11/05,22:10,62,0,1,1,2022/11/05 10:10:00 PM
2022/11/05,22:10,30,4,13,17,2022/11/05 10:10:00 PM
2022/11/05,22:11,62,2,1,3,2022/11/05 10:11:00 PM
2022/11/05,22:10,35,19,16,35,2022/11/05 10:10:00 PM
2022/11/05,22:08,43,2,0,2,2022/11/05 10:08:00 PM
2022/11/05,22:08,21,7,6,13,2022/11/05 10:08:00 PM
2022/11/05,22:10,14,2,1,3,2022/11/05 10:10:00 PM
2022/11/05,22:14,77,0,1,1,2022/11/05 10:14:00 PM
2022/11/05,22:12,47,3,9,12,2022/11/05 10:12:00 PM
2022/11/05,22:10,61,5,3,8,2022/11/05 10:10:00 PM
2022/11/05,22:18,50,3,5,8,2022/11/05 10:18:00 PM
2022/11/05,22:09,41,19,14,33,2022/11/05 10:09:00 PM
2022/11/05,22:09,47,9,11,20,2022/11/05 10:09:00 PM
2022/11/05,22:12,84,10,8,18,2022/11/05 10:12:00 PM
2022/11/05,22:14,84,1,20,21,2022/11/05 10:14:00 PM
2022/11/05,22:14,24,6,3,9,2022/11/05 10:14:00 PM
2022/11/05,22:09,37,6,20,26,2022/11/05 10:09:00 PM
2022/11/05,22:12,62,5,2,7,2022/11/05 10:12:00 PM
2022/11/05,22:09,2,2,19,21,2022/11/05 10:09:00 PM
2022/11/05,22:16,84,10,10,20,2022/11/05 10:16:00 PM
2022/11/05,22:17,66,8,9,17,2022/11/05 10:17:00 PM
2022/11/05,22:14,57,4,4,8,2022/11/05 10:14:00 PM
2022/11/05,22:15,50,5,2,7,2022/11/05 10:15:00 PM
2022/11/05,22:10,84,13,12,25,2022/11/05 10:10:00 PM
2022/11/05,22:09,5,13,5,18,2022/11/05 10:09:00 PM
2022/11/05,22:09,42,5,0,5,2022/11/05 10:09:00 PM
2022/11/05,22:16,3,9,16,25,2022/11/05 10:16:00 PM
2022/11/05,22:12,56,4,1,5,2022/11/05 10:12:00 PM
2022/11/05,22:10,21,5,5,10,2022/11/05 10:10:00 PM
2022/11/05,22:15,86,2,0,2,2022/11/05 10:15:00 PM
2022/11/05,22:09,6,13,6,19,2022/11/05 10:09:00 PM
2022/11/05,22:17,68,2,4,6,2022/11/05 10:17:00 PM
2022/11/05,22:17,67,9,1,10,2022/11/05 10:17:00 PM
2022/11/05,22:08,54,4,4,8,2022/11/05 10:08:00 PM
2022/11/05,22:08,20,2,0,2,2022/11/05 10:08:00 PM
2022/11/05,22:09,28,8,77,85,2022/11/05 10:09:00 PM
2022/11/05,22:16,27,0,1,1,2022/11/05 10:16:00 PM
2022/11/05,22:17,77,3,0,3,2022/11/05 10:17:00 PM
2022/11/05,22:09,57,2,0,2,2022/11/05 10:09:00 PM
2022/11/05,22:12,31,6,12,18,2022/11/05 10:12:00 PM
2022/11/05,22:16,58,1,6,7,2022/11/05 10:16:00 PM
2022/11/05,22:08,58,0,5,5,2022/11/05 10:08:00 PM
2022/11/05,22:14,49,0,2,2,2022/11/05 10:14:00 PM
2022/11/05,22:12,65,2,7,9,2022/11/05 10:12:00 PM
2022/11/05,22:12,12,0,1,1,2022/11/05 10:12:00 PM
2022/11/05,22:14,19,10,3,13,2022/11/05 10:14:00 PM
2022/11/05,22:15,51,0,13,13,2022/11/05 10:15:00 PM
2022/11/05,22:14,20,9,1,10,2022/11/05 10:14:00 PM
2022/11/05,22:08,51,1,2,3,2022/11/05 10:08:00 PM
2022/11/05,22:10,42,2,0,2,2022/11/05 10:10:00 PM
2022/11/05,22:15,68,0,1,1,2022/11/05 10:15:00 PM
2022/11/05,22:13,24,8,2,10,2022/11/05 10:13:00 PM
2022/11/05,22:13,19,2,4,6,2022/11/05 10:13:00 PM
2022/11/05,22:18,56,0,4,4,2022/11/05 10:18:00 PM
2022/11/05,22:10,65,0,5,5,2022/11/05 10:10:00 PM
2022/11/05,22:16,56,0,3,3,2022/11/05 10:16:00 PM
2022/11/05,22:09,72,10,21,31,2022/11/05 10:09:00 PM
2022/11/05,22:18,11,0,4,4,2022/11/05 10:18:00 PM
2022/11/05,22:09,50,8,5,13,2022/11/05 10:09:00 PM
2022/11/05,22:12,11,1,0,1,2022/11/05 10:12:00 PM
2022/11/05,22:11,49,0,1,1,2022/11/05 10:11:00 PM
2022/11/05,22:12,1,12,2,14,2022/11/05 10:12:00 PM
2022/11/05,22:12,57,1,0,1,2022/11/05 10:12:00 PM
2022/11/05,22:10,2,23,60,83,2022/11/05 10:10:00 PM
2022/11/05,22:08,3,3,5,8,2022/11/05 10:08:00 PM
2022/11/05,22:12,45,1,10,11,2022/11/05 10:12:00 PM
2022/11/05,22:09,87,1,0,1,2022/11/05 10:09:00 PM
2022/11/05,22:15,2,2,3,5,2022/11/05 10:15:00 PM
2022/11/05,22:08,10,1,0,1,2022/11/05 10:08:00 PM
2022/11/05,22:16,59,4,3,7,2022/11/05 10:16:00 PM
2022/11/05,22:14,18,3,3,6,2022/11/05 10:14:00 PM
2022/11/05,22:14,14,13,4,17,2022/11/05 10:14:00 PM
2022/11/05,22:10,29,9,4,13,2022/11/05 10:10:00 PM
2022/11/05,22:09,46,0,2,2,2022/11/05 10:09:00 PM
2022/11/05,22:09,56,0,5,5,2022/11/05 10:09:00 PM
2022/11/05,22:13,37,4,6,10,2022/11/05 10:13:00 PM
2022/11/05,22:18,41,6,12,18,2022/11/05 10:18:00 PM
2022/11/05,22:16,45,4,11,15,2022/11/05 10:16:00 PM
2022/11/05,22:09,69,2,0,2,2022/11/05 10:09:00 PM
2022/11/05,22:13,49,3,0,3,2022/11/05 10:13:00 PM
2022/11/05,22:12,59,11,1,12,2022/11/05 10:12:00 PM
2022/11/05,22:11,65,1,6,7,2022/11/05 10:11:00 PM
2022/11/05,22:16,42,2,5,7,2022/11/05 10:16:00 PM
2022/11/05,22:12,24,8,0,8,2022/11/05 10:12:00 PM
2022/11/05,22:08,28,0,75,75,2022/11/05 10:08:00 PM
2022/11/05,22:13,8,0,2,2,2022/11/05 10:13:00 PM
2022/11/05,22:13,67,4,2,6,2022/11/05 10:13:00 PM
2022/11/05,22:14,65,4,16,20,2022/11/05 10:14:00 PM
2022/11/05,22:18,29,33,9,42,2022/11/05 10:18:00 PM
2022/11/05,22:13,66,8,16,24,2022/11/05 10:13:00 PM
2022/11/05,22:08,50,0,2,2,2022/11/05 10:08:00 PM
2022/11/05,22:18,67,2,0,2,2022/11/05 10:18:00 PM
2022/11/05,22:14,68,1,1,2,2022/11/05 10:14:00 PM
2022/11/05,22:13,4,18,14,32,2022/11/05 10:13:00 PM
2022/11/05,22:11,69,1,0,1,2022/11/05 10:11:00 PM
2022/11/05,22:10,54,5,3,8,2022/11/05 10:10:00 PM
2022/11/05,22:09,30,9,15,24,2022/11/05 10:09:00 PM
2022/11/05,22:17,3,13,14,27,2022/11/05 10:17:00 PM
2022/11/05,22:17,63,18,1,19,2022/11/05 10:17:00 PM
2022/11/05,22:12,70,1,3,4,2022/11/05 10:12:00 PM
2022/11/05,22:09,1,5,2,7,2022/11/05 10:09:00 PM
2022/11/05,22:16,54,2,0,2,2022/11/05 10:16:00 PM
2022/11/05,22:12,68,1,0,1,2022/11/05 10:12:00 PM
2022/11/05,22:15,72,3,4,7,2022/11/05 10:15:00 PM
2022/11/05,22:17,29,25,7,32,2022/11/05 10:17:00 PM
2022/11/05,22:15,59,7,4,11,2022/11/05 10:15:00 PM
2022/11/05,22:09,44,2,0,2,2022/11/05 10:09:00 PM
2022/11/05,22:13,61,0,2,2,2022/11/05 10:13:00 PM
2022/11/05,22:09,77,0,4,4,2022/11/05 10:09:00 PM
2022/11/05,22:18,59,14,6,20,2022/11/05 10:18:00 PM
2022/11/05,22:10,50,11,0,11,2022/11/05 10:10:00 PM
2022/11/05,22:09,4,29,4,33,2022/11/05 10:09:00 PM
2022/11/05,22:15,69,0,1,1,2022/11/05 10:15:00 PM
2022/11/05,22:12,9,2,0,2,2022/11/05 10:12:00 PM
2022/11/05,22:08,4,10,13,23,2022/11/05 10:08:00 PM
2022/11/05,22:08,49,0,1,1,2022/11/05 10:08:00 PM
2022/11/05,22:13,77,0,7,7,2022/11/05 10:13:00 PM
2022/11/05,22:12,49,1,0,1,2022/11/05 10:12:00 PM
2022/11/05,22:08,8,2,2,4,2022/11/05 10:08:00 PM
2022/11/05,22:16,79,10,5,15,2022/11/05 10:16:00 PM
2022/11/05,22:11,45,0,11,11,2022/11/05 10:11:00 PM
2022/11/05,22:10,63,4,8,12,2022/11/05 10:10:00 PM
2022/11/05,22:17,24,6,2,8,2022/11/05 10:17:00 PM
2022/11/05,22:15,77,2,0,2,2022/11/05 10:15:00 PM
2022/11/05,22:13,65,0,16,16,2022/11/05 10:13:00 PM
2022/11/05,22:15,58,6,6,12,2022/11/05 10:15:00 PM
2022/11/05,22:15,4,11,7,18,2022/11/05 10:15:00 PM
2022/11/05,22:10,37,2,4,6,2022/11/05 10:10:00 PM
2022/11/05,22:16,20,7,3,10,2022/11/05 10:16:00 PM
2022/11/05,22:13,1,0,2,2,2022/11/05 10:13:00 PM
2022/11/05,22:12,35,25,13,38,2022/11/05 10:12:00 PM
2022/11/05,22:08,40,3,2,5,2022/11/05 10:08:00 PM
2022/11/05,22:08,24,26,2,28,2022/11/05 10:08:00 PM
2022/11/05,22:13,42,1,3,4,2022/11/05 10:13:00 PM
2022/11/05,22:08,19,9,5,14,2022/11/05 10:08:00 PM
2022/11/05,22:14,59,1,5,6,2022/11/05 10:14:00 PM
2022/11/05,22:13,45,3,15,18,2022/11/05 10:13:00 PM
2022/11/05,22:18,79,15,4,19,2022/11/05 10:18:00 PM
2022/11/05,22:15,63,16,5,21,2022/11/05 10:15:00 PM
2022/11/05,22:11,8,3,1,4,2022/11/05 10:11:00 PM
2022/11/05,22:17,79,10,0,10,2022/11/05 10:17:00 PM
2022/11/05,22:13,87,2,0,2,2022/11/05 10:13:00 PM
2022/11/05,22:10,47,7,5,12,2022/11/05 10:10:00 PM
2022/11/05,22:12,63,2,63,65,2022/11/05 10:12:00 PM
2022/11/05,22:10,77,4,2,6,2022/11/05 10:10:00 PM
2022/11/05,22:17,1,0,12,12,2022/11/05 10:17:00 PM
2022/11/05,22:17,70,1,0,1,2022/11/05 10:17:00 PM
2022/11/05,22:08,61,2,4,6,2022/11/05 10:08:00 PM
2022/11/05,22:10,6,14,6,20,2022/11/05 10:10:00 PM
2022/11/05,22:14,45,1,9,10,2022/11/05 10:14:00 PM
2022/11/05,22:08,5,6,19,25,2022/11/05 10:08:00 PM
2022/11/05,22:11,67,1,2,3,2022/11/05 10:11:00 PM
2022/11/05,22:11,19,5,6,11,2022/11/05 10:11:00 PM
2022/11/05,22:10,45,4,11,15,2022/11/05 10:10:00 PM
2022/11/05,22:16,4,19,4,23,2022/11/05 10:16:00 PM
2022/11/05,22:13,56,1,2,3,2022/11/05 10:13:00 PM
2022/11/05,22:09,70,4,5,9,2022/11/05 10:09:00 PM
2022/11/05,22:13,30,13,5,18,2022/11/05 10:13:00 PM
2022/11/05,22:16,49,3,6,9,2022/11/05 10:16:00 PM
2022/11/05,22:12,51,0,1,1,2022/11/05 10:12:00 PM
2022/11/05,22:15,79,9,8,17,2022/11/05 10:15:00 PM
2022/11/05,22:10,57,0,2,2,2022/11/05 10:10:00 PM
2022/11/05,22:10,67,3,0,3,2022/11/05 10:10:00 PM
2022/11/05,22:11,2,0,22,22,2022/11/05 10:11:00 PM
2022/11/05,22:13,62,0,1,1,2022/11/05 10:13:00 PM
2022/11/05,22:17,51,1,5,6,2022/11/05 10:17:00 PM
2022/11/05,22:19,59,11,3,14,2022/11/05 10:19:00 PM
2022/11/05,22:13,12,2,7,9,2022/11/05 10:13:00 PM
2022/11/05,22:18,24,5,5,10,2022/11/05 10:18:00 PM
2022/11/05,22:17,62,2,0,2,2022/11/05 10:17:00 PM
2022/11/05,22:08,23,2,2,4,2022/11/05 10:08:00 PM
2022/11/05,22:12,18,5,0,5,2022/11/05 10:12:00 PM
2022/11/05,22:11,30,8,2,10,2022/11/05 10:11:00 PM
2022/11/05,22:11,1,1,3,4,2022/11/05 10:11:00 PM
2022/11/05,22:08,69,1,0,1,2022/11/05 10:08:00 PM
2022/11/05,22:17,47,6,4,10,2022/11/05 10:17:00 PM
2022/11/05,22:08,62,0,1,1,2022/11/05 10:08:00 PM
2022/11/05,22:13,31,12,5,17,2022/11/05 10:13:00 PM
2022/11/05,22:15,87,0,3,3,2022/11/05 10:15:00 PM
2022/11/05,22:08,35,41,9,50,2022/11/05 10:08:00 PM
2022/11/05,22:09,27,0,1,1,2022/11/05 10:09:00 PM
2022/11/05,22:16,85,0,1,1,2022/11/05 10:16:00 PM
2022/11/05,22:17,42,0,1,1,2022/11/05 10:17:00 PM
2022/11/05,22:15,12,2,0,2,2022/11/05 10:15:00 PM
2022/11/05,22:15,27,0,1,1,2022/11/05 10:15:00 PM
2022/11/05,22:09,19,9,16,25,2022/11/05 10:09:00 PM
2022/11/05,22:14,51,0,14,14,2022/11/05 10:14:00 PM
2022/11/05,22:17,54,2,2,4,2022/11/05 10:17:00 PM
2022/11/05,22:08,45,6,8,14,2022/11/05 10:08:00 PM
2022/11/05,22:18,72,10,20,30,2022/11/05 10:18:00 PM
2022/11/05,22:16,9,0,1,1,2022/11/05 10:16:00 PM
2022/11/05,22:12,54,3,4,7,2022/11/05 10:12:00 PM
2022/11/05,22:10,20,7,0,7,2022/11/05 10:10:00 PM
2022/11/05,22:10,4,10,16,26,2022/11/05 10:10:00 PM
2022/11/05,22:10,11,1,2,3,2022/11/05 10:10:00 PM
2022/11/05,22:11,68,2,3,5,2022/11/05 10:11:00 PM
2022/11/05,22:15,11,1,0,1,2022/11/05 10:15:00 PM
2022/11/05,22:15,1,2,4,6,2022/11/05 10:15:00 PM
2022/11/05,22:13,20,6,14,20,2022/11/05 10:13:00 PM
2022/11/05,22:09,63,3,2,5,2022/11/05 10:09:00 PM
2022/11/05,22:13,14,19,2,21,2022/11/05 10:13:00 PM
2022/11/05,22:16,14,8,6,14,2022/11/05 10:16:00 PM
2022/11/05,22:13,79,8,5,13,2022/11/05 10:13:00 PM
2022/11/05,22:08,30,11,7,18,2022/11/05 10:08:00 PM
2022/11/05,22:12,77,1,0,1,2022/11/05 10:12:00 PM
2022/11/05,22:16,50,15,2,17,2022/11/05 10:16:00 PM
2022/11/05,22:15,66,6,6,12,2022/11/05 10:15:00 PM
2022/11/05,22:18,87,2,0,2,2022/11/05 10:18:00 PM
2022/11/05,22:17,41,15,24,39,2022/11/05 10:17:00 PM
2022/11/05,22:15,67,4,4,8,2022/11/05 10:15:00 PM
2022/11/05,22:10,31,9,7,16,2022/11/05 10:10:00 PM
2022/11/05,22:14,71,0,1,1,2022/11/05 10:14:00 PM
2022/11/05,22:11,40,0,3,3,2022/11/05 10:11:00 PM
2022/11/05,22:13,86,1,0,1,2022/11/05 10:13:00 PM
2022/11/05,22:14,47,2,10,12,2022/11/05 10:14:00 PM
2022/11/05,22:11,61,5,1,6,2022/11/05 10:11:00 PM
2022/11/05,22:18,63,12,6,18,2022/11/05 10:18:00 PM
2022/11/05,22:15,35,57,18,75,2022/11/05 10:15:00 PM
2022/11/05,22:12,19,4,10,14,2022/11/05 10:12:00 PM
2022/11/05,22:18,86,3,0,3,2022/11/05 10:18:00 PM
